挨着	挨著	āi zhe	near;  
挨	挨	āi, ái	in order; in sequence; close to; adjacent to;  to suffer; to endure; to pull through (hard times); to delay; to stall; to play for time; to dawdle;  
挨打	挨打	ái dǎ	to take a beating; to get thrashed; to come under attack;  
安检	安檢	ān jiǎn	safety check;  
罢工	罷工	bà gōng	a strike; to go on strike;  
罢了	罷瞭	bà le, bà liǎo	a modal particle indicating (that's all, only, nothing much);  a modal particle indicating (don't mind it, ok);  
白领	白領	bái lǐng	white collar; business person;  
百分点	百分點	bǎi fēn diǎn	percentage point;  
办公	辦公	bàn gōng	to handle official business; to work (esp. in an office);  
办事处	辦事處	bàn shì chù	office; agency;  
办学	辦學	bàn xué	to run a school;  
半决赛	半決賽	bàn jué sài	semifinals;  
傍晚	傍晚	bàng wǎn	in the evening; when night falls; towards evening; at night fall; at dusk;  
保健	保健	bǎo jiàn	health protection; health care; to maintain in good health;  
报刊	報刊	bào kān	newspapers and periodicals; the press;  
报考	報考	bào kǎo	to enter oneself for an examination;  
抱歉	抱歉	bào qiàn	to be sorry; to feel apologetic; sorry!;  
暴风雨	暴風雨	bào fēng yǔ	rainstorm; storm; tempest;  
暴力	暴力	bào lì	violence; force; violent;  
暴露	暴露	bào lù	to expose; to reveal; to lay bare; also pr. [pu4 lu4];  
暴雨	暴雨	bào yǔ	torrential rain; rainstorm; CL:場|场[chang2],陣|阵[zhen4];  
爆	爆	bào	to explode or burst; to quick fry or quick boil;  
爆发	爆發	bào fā	to break out; to erupt; to explode; to burst out;  
爆炸	爆炸	bào zhà	explosion; to explode; to blow up; to detonate;  
悲惨	悲慘	bēi cǎn	miserable; tragic;  
背心	背心	bèi xīn	sleeveless garment (vest, waistcoat, singlet, tank top etc); CL:件[jian4];  
背着	背著	bèizháo	Carry on
被告	被告	bèi gào	defendant;  
奔跑	奔跑	bēn pǎo	to run;  
本	本	běn	root; stem; origin; source; this; the current; original; inherent; originally; classifier for books, periodicals, files etc;  
本地	本地	běn dì	local; this locality;  
本期	本期	běn qī	the current period; this term (usually in finance);  
本身	本身	běn shēn	itself; in itself; per se;  
本土	本土	běn tǔ	one's native country; native; local; metropolitan territory;  
本质	本質	běn zhì	essence; nature; innate character; intrinsic quality;  
逼	逼	bī, bī	to force (sb to do sth); to compel; to press for; to extort; to press on towards; to press up to; to close in on; used in the place of 屄[bi1], cunt;  
笔试	筆試	bǐ shì	written examination; paper test (for an applicant);  
必将	必將	bì jiāng	inevitably;  
必修	必修	bì xiū	a required course;  
闭	閉	bì	to close; to stop up; to shut; to obstruct;  
边缘	邊緣	biān yuán	edge; fringe; verge; brink; periphery; marginal; borderline;  
编制	編製	biān zhì, biān zhì	to weave; to plait; to compile; to put together (a lesson plan, budget etc);  
扁	扁	Piān, biǎn, piān	surname Pian;  flat; (coll.) to beat (sb) up; old variant of 匾[bian3];  small boat;  
变更	變更	biàn gēng	to change; to alter; to modify;  
变换	變換	biàn huàn	to transform; to convert; to vary; to alternate; a transformation;  
变形	變形	biàn xíng	deformation; to become deformed; to change shape; to morph;  
便	便	biàn, pián	plain; informal; suitable; convenient; opportune; to urinate or defecate; equivalent to 就[jiu4]: then; in that case; even if; soon afterwards;  see 便宜|便宜[pian2 yi5];  
便是	便是	biàn shì	(emphasizes that sth is precisely or exactly as stated); precisely; exactly; even; if; just like; in the same way as;  
遍地	遍地	biàn dì	everywhere; all over;  
表面上	錶麵上	biǎomiànshàng	Surface on the surface
病房	病房	bìng fáng	ward (of a hospital); sickroom; CL:間|间[jian1];  
病情	病情	bìng qíng	state of an illness; patient's condition;  
拨打	撥打	bō dǎ	to call; to dial;  
波动	波動	bō dòng	to undulate; to fluctuate; wave motion; rise and fall;  
波浪	波浪	bō làng	wave;  
播	播	bō	to sow; to scatter; to spread; to broadcast; Taiwan pr. [bo4];  
不便	不便	bù biàn	inconvenient; inappropriate; unsuitable; short of cash;  
不见	不見	bù jiàn	not to see; not to meet; to have disappeared; to be missing;  
不料	不料	bù liào	unexpectedly; to one's surprise;  
不再	不再	bù zài	no more; no longer;  
不至于	不至於	bù zhì yú	unlikely to go so far as to; not as bad as;  
补考	補考	bǔ kǎo	to sit for a makeup exam; to resit an exam; makeup exam; resit;  
补课	補課	bǔ kè	to make up missed lesson; to reschedule a class;  
补习	補習	bǔ xí	to take extra lessons in a cram school or with a private tutor;  
补助	補助	bǔ zhù	to subsidize; subsidy; allowance;  
捕	捕	bǔ	to catch; to seize; to capture;  
不成	不成	bù chéng	won't do; unable to; (at the end of a rhetorical question) can that be?;  
不禁	不禁	bù jīn	can't help (doing sth); can't refrain from;  
不仅仅	不僅僅	bùjǐnjǐn	Not only
不通	不通	bù tōng	to be obstructed; to be blocked up; to be impassable; to make no sense; to be illogical;  
不怎么	不怎麼	bù zěn me	not very; not particularly;  
不怎么样	不怎麼樣	bù zěn me yàng	not up to much; very indifferent; nothing great about it; nothing good to be said about it;  
不值	不值	bù zhí	not worth;  
布满	布滿	bù mǎn	to be covered with; to be filled with;  
部队	部隊	bù duì	army; armed forces; troops; force; unit; CL:個|个[ge4];  
采纳	采納	cǎi nà	to accept; to adopt;  
踩	踩	cǎi, cǎi	to step on; to tread; to stamp; to press a pedal; to pedal (a bike);  
参赛	參賽	cān sài	to compete; to take part in a competition;  
参展	參展	cān zhǎn	to exhibit at or take part in a trade show etc;  
餐	餐	cān	meal; to eat; classifier for meals;  
残疾	殘疾	cán jí	disabled; handicapped; deformity on a person or animal;  
残疾人	殘疾人	cán jí rén	disabled person;  
残酷	殘酷	cán kù	cruel; cruelty;  
惨	慘	cǎn	miserable; wretched; cruel; inhuman; disastrous; tragic; dim; gloomy;  
仓库	倉庫	cāng kù	depot; storehouse; warehouse;  
藏	藏	Zàng, cáng, zàng	Tibet; Xizang 西藏;  to conceal; to hide away; to harbor; to store; to collect;  storehouse; depository; Buddhist or Taoist scripture;  
操纵	操縱	cāo zòng	to operate; to control; to rig; to manipulate;  
厕所	廁所	cè suǒ	toilet; lavatory; CL:間|间[jian1],處|处[chu4];  
侧	側	cè, zhāi	the side; to incline towards; to lean; inclined; lateral; side;  lean on one side;  
测定	測定	cè dìng	to survey and evaluate;  
策划	策劃	cè huà	to plot; to scheme; to bring about; to engineer; planning; producer; planner;  
策略	策略	cè lüè	tactics; to be tactful;  
层面	層麵	céng miàn	aspect; facet; level (political, psychological, spiritual etc); (geology) bedding plane;  
差异	差異	chā yì	difference; discrepancy;  
查出	查齣	chá chū	to find out; to discover;  
查看	查看	chá kàn	to look over; to examine; to check up; to ferret out;  
拆迁	拆遷	chāi qiān	to demolish a building and relocate the inhabitants;  
产量	産量	chǎn liàng	output;  
昌盛	昌盛	chāng shèng	prosperous;  
长短	長短	cháng duǎn	length; duration; accident; right and wrong; good and bad; long and short;  
长假	長假	cháng jià	long vacation; refers to one week national holiday in PRC starting 1st May and 1st Oct;  
长久	長久	cháng jiǔ	(for a) long time;  
长跑	長跑	cháng pǎo	long-distance running;  
长远	長遠	cháng yuǎn	long-term; long-range;  
常规	常規	cháng guī	code of conduct; conventions; common practice; routine (medical procedure etc);  
常年	常年	cháng nián	all year round; for years on end; average year;  
厂商	廠商	chǎng shāng	manufacturer; producer;  
场地	場地	chǎng dì	space; site; place; sports pitch;  
场馆	場館	chǎng guǎn	sporting venue; arena;  
场景	場景	chǎng jǐng	scene; scenario; setting;  
畅通	暢通	chàng tōng	unimpeded; free-flowing; straight path; unclogged; move without obstruction;  
超	超	chāo	to exceed; to overtake; to surpass; to transcend; to pass; to cross; ultra-; super-;  
超出	超齣	chāo chū	to exceed; to overstep; to go too far; to encroach;  
炒	炒	chǎo	to sauté; to stir-fry; to speculate; to hype; to fire (sb);  
炒股	炒股	chǎo gǔ	(coll.) to speculate in stocks;  
炒作	炒作	chǎo zuò	to hype; to promote (in the media);  
车号	車號	chēhào	Car number
车牌	車牌	chē pái	license plate;  
车展	車展	chē zhǎn	motor show;  
撤离	撤離	chè lí	to withdraw from; to evacuate;  
撤销	撤銷	chè xiāo	to repeal; to revoke; (computing) to undo;  
撑	撐	chēng	to support; to prop up; to push or move with a pole; to maintain; to open or unfurl; to fill to bursting point; brace; stay; support;  
成	成	Chéng, chéng	surname Cheng;  to succeed; to finish; to complete; to accomplish; to become; to turn into; to be all right; OK!; one tenth;  
成分	成分	chéng fèn	composition; make-up; ingredient; element; component; one's social status; CL:個|个[ge4];  
成品	成品	chéng pǐn	finished goods; a finished product;  
承诺	承諾	chéng nuò	to promise; to undertake to do something; commitment;  
城区	城區	chéng qū	city district; urban area;  
城乡	城鄉	chéng xiāng	city and countryside;  
城镇	城鎮	chéng zhèn	town; cities and towns;  
持有	持有	chí yoǔ	to hold (passport, views etc);  
冲击	衝擊	chōng jī	to attack; to batter; (of waves) to pound against; shock; impact;  
重建	重建	chóng jiàn	to rebuild; to reestablish; reconstruction; rebuilding;  
重组	重組	chóng zǔ	to reorganize; to recombine; recombination;  
崇拜	崇拜	chóng bài	to worship; adoration;  
宠物	寵物	chǒng wù	house pet;  
冲	衝	chōng, chōng, chòng	thoroughfare; to go straight ahead; to rush; to clash;  powerful; vigorous; pungent; towards; in view of;  
出场	齣場	chū chǎng	to appear (on stage, in a show, in a photo etc); to play (for a team); to enter (arena or stage); to send sb out (e.g. off the field for a foul);  
出动	齣動	chū dòng	to start out on a trip; to dispatch troops;  
出访	齣訪	chū fǎng	to travel on business; to visit (a foreign country); same as 外出訪問|外出访问[wai4 chu1 fang3 wen4];  
出路	齣路	chū lù	a way out (of a difficulty etc);  
出面	齣麵	chū miàn	to appear personally; to step in; to step forth; to show up;  
出名	齣名	chū míng	well-known for sth; to become well known; to make one's mark;  
出入	齣入	chū rù	to go out and come in; entrance and exit; expenditure and income; discrepancy; inconsistent;  
出事	齣事	chū shì	to have an accident; to meet with a mishap;  
出台	齣颱	chū tái	to officially launch (a policy, program etc); to appear on stage; to appear publicly; (of a bar girl) to leave with a client;  
出行	齣行	chū xíng	to set out on a long journey; to travel afar;  
初等	初等	chū děng	elementary (i.e. easy);  
除	除	chú	to get rid of; to remove; to exclude; to eliminate; to wipe out; to divide; except; not including;  
厨师	廚師	chú shī	cook; chef;  
储存	儲存	chǔ cún	stockpile; to store; to stockpile; storage;  
处处	處處	chù chù	everywhere; in all respects;  
处长	處長	chù zhǎng	department head; section chief;  
传出	傳齣	chuán chū	to transmit outwards; to disseminate; efferent (nerve);  
传媒	傳媒	chuán méi	media;  
传输	傳輸	chuán shū	to transmit; transmission;  
传言	傳言	chuán yán	rumor; hearsay;  
船员	船員	chuán yuán	sailor; crew member;  
船长	船長	chuán zhǎng	captain (of a boat); skipper;  
船只	船隻	chuán zhī	ship; boat; vessel;  
串	串	chuàn	to string together; to skewer; to connect wrongly; to gang up; to rove; string; bunch; skewer; classifier for things that are strung together, or in a bunch, or in a row: string of, bunch of, series of; to make a swift or abrupt linear movement (like a bead on an abacus); to move across;  
窗口	窗口	chuāng koǔ	window; opening providing restricted access (e.g. customer service window); computer operating system window; fig. medium; intermediary; showpiece; testing ground;  
创办	創辦	chuàng bàn	to establish; to found; to launch;  
创建	創建	chuàng jiàn	to found; to establish;  
创意	創意	chuàng yì	creative; creativity;  
此处	此處	cǐ chù	this place; here (literary);  
此次	此次	cǐ cì	this time;  
此前	此前	cǐ qián	before this; before then; previously;  
此事	此事	cǐshì	This matter
此致	此緻	cǐ zhì	(used at the end of a letter to introduce a polite salutation);  
次数	次數	cì shù	number of times; frequency; order number (in a series); power (math.); degree of a polynomial (math.);  
从不	從不	cóng bù	never;  
从没	從沒	cóng méi	never (in the past); never did;  
醋	醋	cù	vinegar; jealousy (in love rivalry);  
村庄	村莊	cūn zhuāng	village; hamlet; CL:座[zuo4];  
错过	錯過	cuò guò	to miss (train, opportunity etc);  
搭	搭	dā	to put up; to build (scaffolding); to hang (clothes on a pole); to connect; to join; to arrange in pairs; to match; to add; to throw in (resources); to take (boat, train); variant of 褡[da1];  
搭档	搭檔	dā dàng	to cooperate; partner;  
搭配	搭配	dā pèi	to pair up; to match; to arrange in pairs; to add sth into a group;  
打动	打動	dǎ dòng	to move (to pity); arousing (sympathy); touching;  
打断	打斷	dǎ duàn	to interrupt; to break off; to break (a bone);  
打发	打發	dǎ fa	to dispatch sb to do sth; to make sb leave; to pass (the time); (old) to make arrangements; (old) to bestow (alms etc);  
打官司	打官司	dǎ guān si	to file a lawsuit; to sue; to dispute;  
打牌	打牌	dǎ pái	to play mahjong or cards;  
打印机	打印機	dǎ yìn jī	printer;  
打造	打造	dǎ zào	to create; to build; to develop; to forge (of metal);  
大道	大道	dà dào	main street; avenue;  
大街	大街	dà jiē	street; main street; CL:條|条[tiao2];  
大力	大力	dà lì	energetically; vigorously;  
大米	大米	dà mǐ	(husked) rice;  
大批	大批	dà pī	large quantities of;  
大赛	大賽	dàsài	Contest
大师	大師	dà shī	great master; master;  
大使	大使	dà shǐ	ambassador; envoy; CL:名[ming2],位[wei4];  
待会儿	待會兒	dai1 hui4 r5	in a moment; later; Taiwan pr. [dai1 hui3 r5];  
担忧	擔憂	dān yoū	to worry; to be concerned;  
单打	單打	dān dǎ	singles (in sports); CL:場|场[chang3];  
诞生	誕生	dàn shēng	to be born;  
党	黨	Dǎng, dǎng	surname Dang;  party; association; club; society; CL:個|个[ge4];  
当	當	dāng, dāng, dàng	to be; to act as; manage; withstand; when; during; ought; should; match equally; equal; same; obstruct; just at (a time or place); on the spot; right; just at;  at or in the very same...; suitable; adequate; fitting; proper; to replace; to regard as; to think; to pawn; (coll.) to fail (a student);  
当成	當成	dàng chéng	to consider as; to take to be;  
当天	當天	dāng tiān, dàng tiān	on that day;  the same day;  
当作	當作	dàng zuò	to treat as; to regard as;  
档	檔	dǎng, dàng	(Tw) variant of 擋|挡[dang3], gear;  official records; grade (of goods); file; records; shelves; slot; gap; crosspiece; classifier for crosspieces; classifier for events, affairs etc; Taiwan pr. [dang3];  
档案	檔案	dàng àn	file; record; archive;  
岛	島	dǎo, dǎo	island; CL:個|个[ge4],座[zuo4];  
到期	到期	dào qī	to fall due (loan etc); to expire (visa etc); to mature (investment bond etc);  
盗版	盜版	dào bǎn	pirated; illegal; see also 正版[zheng4 ban3];  
道教	道教	Dào jiào	Taoism; Daoism (Chinese system of beliefs);  
道歉	道歉	dào qiàn	to apologize;  
低头	低頭	dī toú	to bow the head; to yield; to give in;  
低温	低溫	dī wēn	low temperature;  
滴	滴	dī	a drop; to drip;  
抵达	抵達	dǐ dá	to arrive; to reach (a destination);  
抵抗	抵抗	dǐ kàng	to resist; resistance;  
地板	地闆	dì bǎn	floor;  
地名	地名	dì míng	place name; toponym;  
地下室	地下室	dì xià shì	basement; cellar;  
电车	電車	diàn chē	trolleybus; CL:輛|辆[liang4];  
电动	電動	diàn dòng	electric-powered; (Tw) video game;  
电力	電力	diàn lì	electrical power; electricity;  
电器	電器	diàn qì	(electrical) appliance; device;  
吊	吊	diào, diào	a string of 100 cash (arch.); to lament; to condole with; variant of 吊[diao4];  
调研	調研	diào yán	to investigate and research; research; investigation;  
跌	跌	diē	to drop; to fall; to tumble; Taiwan pr. [die2];  
定价	定價	dìng jià	to set a price; to fix a price;  
定时	定時	dìng shí	to fix a time; fixed time; timed (of explosive etc);  
定位	定位	dìng wèi	to orientate; to position; to categorize (as); to characterize (as); positioning; position; niche;  
动画	動畫	dòng huà	animation; cartoon;  
斗争	鬥爭	doù zhēng	a struggle; fight; battle;  
都市	都市	dū shì	city; metropolis;  
毒品	毒品	dú pǐn	drugs; narcotics; poison;  
赌	賭	dǔ	to bet; to gamble;  
赌博	賭博	dǔ bó	to gamble;  
渡	渡	dù	to cross; to pass through; to ferry;  
端	端	duān, duān	old variant of 端[duan1]; start; origin;  
端午节	端午節	Duān wǔ jié	Dragon Boat Festival (5th day of the 5th lunar month);  
短片	短片	duǎn piàn	short film; video clip;  
队伍	隊伍	duì wǔ	ranks; troops; queue; line; procession; CL:個|个[ge4],支[zhi1],條|条[tiao2];  
对抗	對抗	duì kàng	to withstand; to resist; to stand off; antagonism; confrontation;  
对外	對外	duì wài	external; foreign; pertaining to external or foreign (affairs);  
蹲	蹲	dūn	to crouch; to squat; to stay (somewhere);  
多半	多半	duō bàn	most; mostly; most likely;  
多方面	多方麵	duō fāng miàn	many-sided; in many aspects;  
多媒体	多媒體	duō méi tǐ	multimedia;  
夺	奪	duó	to seize; to take away forcibly; to wrest control of; to compete or strive for; to force one's way through; to leave out; to lose;  
夺取	奪取	duó qǔ	to seize; to capture; to wrest control of;  
恩人	恩人	ēn rén	a benefactor; a person who has significantly helped sb else;  
儿科	兒科	ér kē	pediatrics;  
发病	發病	fā bìng	onset; outbreak (of a disease);  
发电	發電	fā diàn	to generate electricity; to send a telegram;  
发放	發放	fā fàng	to provide; to give; to grant;  
发怒	發怒	fā nù	to get angry;  
发起	發起	fā qǐ	to originate; to initiate; to launch (an attack, an initiative etc); to start; to propose sth (for the first time);  
发言人	發言人	fā yán rén	spokesperson;  
发炎	發炎	fā yán	to become inflamed; inflammation;  
法庭	法庭	fǎ tíng	court of law;  
法语	法語	Fǎ yǔ	French (language);  
番	番	Pān, fān	surname Pan;  foreign (non-Chinese); barbarian; classifier for occurrences (of an event, action or speech utterance); classifier for iterations: times, -fold (as in twofold etc); classifier for situations: kind, sort;  
番茄	番茄	fān qié	tomato;  
凡是	凡是	fán shì	each and every; every; all; any;  
繁殖	繁殖	fán zhí	to breed; to reproduce; to propagate;  
反抗	反抗	fǎn kàng	to resist; to rebel;  
反问	反問	fǎn wèn	to ask (a question) in reply; to answer a question with a question; rhetorical question;  
反响	反響	fǎn xiǎng	repercussions; reaction; echo;  
犯	犯	fàn	to violate; to offend; to assault; criminal; crime; to make a mistake; recurrence (of mistake or sth bad);  
犯规	犯規	fàn guī	to break the rules; an illegality; a foul;  
犯罪	犯罪	fàn zuì	to commit a crime; crime; offense;  
防范	防範	fáng fàn	to be on guard; wariness; to guard against; preventive;  
防守	防守	fáng shoǔ	to defend; to protect (against);  
房价	房價	fáng jià	house price; cost of housing;  
仿佛	仿佛	fǎng fú, fǎng fú	to seem; as if; alike; similar;  
飞船	飛船	fēi chuán	airship; spaceship;  
飞行员	飛行員	fēi xíng yuán	pilot; aviator;  
肺	肺	fèi	lung; CL:個|个[ge4];  
分工	分工	fēn gōng	to divide up the work; division of labor;  
分裂	分裂	fēn liè	to split up; to divide; to break up; fission; schism;  
愤怒	憤怒	fèn nù	angry; indignant; wrath; ire;  
风暴	風暴	fēng bào	storm; violent commotion; fig. crisis (e.g. revolution, uprising, financial crisis etc);  
峰会	峰會	fēng huì	summit meeting;  
奉献	奉獻	fèng xiàn	to offer respectfully; to consecrate; to dedicate; to devote;  
佛	佛	Fó, fú, fú	Buddha; Buddhism;  (female) head ornament; variant of 彿|佛[fu2];  
佛教	佛教	Fó jiào	Buddhism;  
服	服	fú, fù	clothes; dress; garment; to serve (in the military, a prison sentence etc); to obey; to convince; to admire; to acclimatize; to take (medicine); mourning clothes; to wear mourning clothes;  dose (measure word for medicine); Taiwan pr. [fu2];  
浮	浮	fú	to float; superficial; floating; unstable; movable; provisional; temporary; transient; impetuous; hollow; inflated; to exceed; superfluous; excessive; surplus;  
父女	父女	fù nǚ	father and daughter;  
父子	父子	fù zǐ	father and son;  
负	負	fù	to bear; to carry (on one's back); to turn one's back on; to be defeated; negative (math. etc);  
妇女	婦女	fù nǚ	woman;  
复苏	復蘇	fù sū, fù sū	variant of 復甦|复苏[fu4 su1]; to recover (health, economic); to resuscitate; anabiosis;  
副	副	fù	secondary; auxiliary; deputy; assistant; vice-; abbr. for 副詞|副词 adverb; classifier for pairs, sets of things & facial expressions;  
副	副	fù	secondary; auxiliary; deputy; assistant; vice-; abbr. for 副詞|副词 adverb; classifier for pairs, sets of things & facial expressions;  
富人	富人	fù rén	rich man;  
富有	富有	fù yoǔ	rich; full of;  
改装	改裝	gǎi zhuāng	to change one's costume; to repackage; to remodel; to refit; to modify; to convert;  
干涉	乾涉	gān shè	to interfere; to meddle; interference;  
肝	肝	gān	liver; CL:葉|叶[ye4],個|个[ge4];  
杆	杆	gān, gǎn	pole; CL:條|条[tiao2],根[gen1];  stick; pole; lever; classifier for long objects such as guns;  
赶不上	趕不上	gǎn bù shàng	can't keep up with; can't catch up with; cannot overtake;  
赶忙	趕忙	gǎn máng	to hurry; to hasten; to make haste;  
赶上	趕上	gǎn shàng	to keep up with; to catch up with; to overtake; to chance upon; in time for;  
敢于	敢於	gǎn yú	to have the courage to do sth; to dare to; bold in;  
感人	感人	gǎn rén	touching; moving;  
刚好	剛好	gāng hǎo	just; exactly; to happen to be;  
岗位	崗位	gǎng wèi	a post; a job;  
港口	港口	gǎng koǔ	port; harbor;  
高层	高層	gāo céng	high level; high class;  
高档	高檔	gāo dàng	superior quality; high grade; top grade;  
高等	高等	gāo děng	higher; high level; advanced;  
高峰	高峰	gāo fēng	peak; summit; height;  
高考	高考	gāo kǎo	college entrance exam (especially as abbr. for 普通高等學校招生全國統一考試|普通高等学校招生全国统一考试[Pu3 tong1 Gao1 deng3 Xue2 xiao4 Zhao1 sheng1 Quan2 guo2 Tong3 yi1 Kao3 shi4]); entrance exam for senior government service posts (Taiwan);  
高科技	高科技	gāo kē jì	high tech; high technology;  
高手	高手	gāo shoǔ	expert; past master; dab hand;  
稿子	稿子	gǎo zi	draft of a document; script; manuscript; mental plan; precedent;  
歌唱	歌唱	gē chàng	to sing;  
歌词	歌詞	gē cí	song lyric; lyrics;  
歌星	歌星	gē xīng	singing star; famous singer;  
革新	革新	gé xīn	to innovate; innovation;  
更是	更是	gèngshì	even more
工商	工商	gōng shāng	industry and commerce;  
公	公	gōng	public; collectively owned; common; international (e.g. high seas, metric system, calendar); make public; fair; just; Duke, highest of five orders of nobility 五等爵位[wu3 deng3 jue2 wei4]; honorable (gentlemen); father-in-law; male (animal);  
公安	公安	gōng ān	(Ministry of) Public Security; public safety; public security;  
公鸡	公雞	gōng jī	cock; rooster;  
公众	公眾	gōng zhòng	public;  
公主	公主	gōng zhǔ	princess;  
攻击	攻擊	gōng jī	to attack; to accuse; to charge; an attack (terrorist or military);  
供给	供給	gōng jǐ	to furnish; to provide; supply (as in supply and demand);  
宫	宮	Gōng, gōng	surname Gong;  palace; temple; castration (as corporal punishment); first note in pentatonic scale;  
巩固	鞏固	gǒng gù	to consolidate; consolidation; to strengthen;  
贡献	貢獻	gòng xiàn	to contribute; to dedicate; to devote; contribution; CL:個|个[ge4];  
构建	構建	goù jiàn	to construct (sth abstract);  
孤独	孤獨	gū dú	lonely; solitary;  
孤儿	孤兒	gū ér	orphan;  
姑姑	姑姑	gū gu	paternal aunt; CL:個|个[ge4];  
古典	古典	gǔ diǎn	classical;  
股	股	gǔ	thigh; part of a whole; portion of a sum; (stock) share; strand of a thread; low-level administrative unit, translated as 'section' or 'department' etc, ranked below 科[ke1]; classifier for long winding things like ropes, rivers etc; classifier for smoke, smells etc: thread, puff, whiff; classifier for bands of people, gangs etc; classifier for sudden forceful actions;  
股东	股東	gǔ dōng	shareholder; stockholder;  
股票	股票	gǔ piào	share certificate; stock (finance);  
故障	故障	gù zhàng	malfunction; breakdown; defect; shortcoming; fault; failure; impediment; error; bug (in software);  
顾	顧	Gù, gù	surname Gu;  to look after; to take into consideration; to attend to;  
刮	颳	guā, guā	to blow (of the wind);  
拐	拐	guǎi	to turn (a corner etc); to kidnap; to swindle; to misappropriate; walking stick; crutch; seven (used as a substitute for 七[qi1]);  
关爱	關愛	guān ài	to show concern and care for;  
关联	關聯	guān lián	related; linked; affiliated;  
观光	觀光	guān guāng	to tour; sightseeing; tourism;  
官司	官司	guān si	lawsuit; CL:場|场[chang2];  
管道	管道	guǎn dào	tubing; pipeline; (fig.) channel; means;  
光辉	光輝	guāng huī	radiance; glory; brilliant; magnificent;  
广阔	廣闊	guǎng kuò	wide; vast;  
轨道	軌道	guǐ dào	orbit; railway or tram line; fig. conventional way of thinking;  
跪	跪	guì	to kneel;  
国产	國産	guó chǎn	made in one's own country; made in China;  
国歌	國歌	guó gē	national anthem;  
国会	國會	guó huì	parliament; Congress; diet;  
国旗	國旗	guó qí	flag (of a country); CL:面[mian4];  
国王	國王	guó wáng	king; CL:個|个[ge4];  
果酱	果醬	guǒ jiàng	jam;  
果树	果樹	guǒ shù	fruit tree; CL:棵[ke1];  
过渡	過渡	guò dù	to cross over (by ferry); transition; interim; caretaker (administration);  
过后	過後	guò hoù	after the event;  
过时	過時	guò shí	old-fashioned; out of date; to be later than the time stipulated or agreed upon;  
海报	海報	hǎi bào	poster; playbill; notice;  
海底	海底	hǎi dǐ	seabed; seafloor; bottom of the ocean;  
海军	海軍	hǎi jūn	navy;  
海浪	海浪	hǎi làng	sea wave;  
海外	海外	hǎi wài	overseas; abroad;  
海湾	海灣	Hǎi wān, hǎi wān	(Persian) Gulf;  bay; gulf (body of water);  
海洋	海洋	hǎi yáng	ocean; CL:個|个[ge4];  
好容易	好容易	hǎo róng yì	with great difficulty; to have a hard time (convincing sb, relinquishing sth etc);  
好似	好似	hǎo sì	to seem; to be like;  
好转	好轉	hǎo zhuǎn	to improve; to take a turn for the better; improvement;  
好学	好學	hào xué	eager to study; studious; erudite;  
合约	閤約	hé yuē	treaty; contract;  
和谐	和諧	hé xié	harmonious; harmony; (euphemism) to censor;  
核心	核心	hé xīn	core; nucleus;  
黑夜	黑夜	hēi yè	night;  
很难说	很難說	hěnnánshuō	Hard to say
狠	狠	hěn	fierce; very;  
横	橫	héng, hèng	horizontal; across; (horizontal character stroke);  harsh and unreasonable; unexpected;  
衡量	衡量	héng liáng	to weigh; to examine; to consider;  
宏大	宏大	hóng dà	great; grand;  
洪水	洪水	hóng shuǐ	deluge; flood;  
忽略	忽略	hū lüè	to neglect; to overlook; to ignore;  
壶	壺	hú	pot; classifier for bottled liquid;  
互动	互動	hù dòng	to interact; interactive;  
户外	戶外	hù wài	outdoor;  
护	護	hù	to protect;  
花费	花費	huā fèi	expense; cost; to spend (time or money); expenditure;  
花瓶	花瓶	huā píng	flower vase; fig. just a pretty face; CL:對|对[dui4];  
花生	花生	huā shēng	peanut; groundnut; CL:粒[li4];  
化解	化解	huà jiě	to dissolve; to resolve (contradictions); to dispel (doubts); to iron out (difficulties); to defuse (conflicts); to neutralize (fears);  
幻想	幻想	huàn xiǎng	delusion; fantasy;  
患者	患者	huàn zhě	patient; sufferer;  
皇帝	皇帝	huáng dì	emperor; CL:個|个[ge4];  
回应	迴應	huí yìng	to respond; response;  
毁	毀	huǐ, huǐ, huǐ	variant of 毀|毁[hui3]; to defame; to slander;  
会见	會見	huì jiàn	to meet with (sb who is paying a visit); CL:次[ci4];  
会长	會長	huì zhǎng	president of a club, committee etc;  
绘画	繪畫	huì huà	drawing; painting;  
昏	昏	hūn, hūn	old variant of 昏[hun1];  
混	混	hún, hùn	confused; dirty; to mix; muddy; variant of 渾|浑[hun2];  to mix; to mingle; muddled; to drift along; to muddle along; to pass for; to get along with sb; thoughtless; reckless;  
混合	混閤	hùn hé	to mix; to blend;  
混乱	混亂	hùn luàn	confusion; chaos; disorder;  
活跃	活躍	huó yuè	active; lively; excited; to enliven; to brighten up;  
火箭	火箭	huǒ jiàn	rocket; CL:枚[mei2];  
机动车	機動車	jī dòng chē	motor vehicle;  
机关	機關	jī guān	mechanism; gear; machine-operated; office; agency; organ; organization; establishment; institution; body; strategum; scheme; intrigue; plot; trick; CL:個|个[ge4];  
机械	機械	jī xiè	machine; machinery; mechanical; (old) cunning; scheming;  
基督教	基督教	Jī dū jiào	Christianity; Christian;  
激情	激情	jī qíng	passion; fervor; enthusiasm; strong emotion;  
吉利	吉利	Jí lì, jí lì	Geely, Chinese car make;  auspicious; lucky; propitious;  
吉祥	吉祥	jí xiáng	lucky; auspicious; propitious;  
极端	極端	jí duān	extreme;  
急救	急救	jí jiù	first aid; emergency treatment;  
疾病	疾病	jí bìng	disease; sickness; ailment;  
集	集	jí	to gather; to collect; collected works; classifier for sections of a TV series etc: episode;  
给予	給予	jǐ yǔ	to accord; to give; to show (respect);  
加盟	加盟	jiā méng	to become a member of an alliance or union; to align; to join; participate;  
家电	傢電	jiā diàn	household electric appliance; abbr. for 家用電器|家用电器;  
家园	傢園	jiā yuán	home; homeland;  
嘉宾	嘉賓	jiā bīn	esteemed guest; honored guest; guest (on a show);  
假日	假日	jià rì	holiday; non-working day;  
尖	尖	jiān	point (of needle); sharp; shrewd; pointed;  
监测	監測	jiān cè	to monitor;  
监督	監督	jiān dū	to control; to supervise; to inspect;  
捡	撿	jiǎn	to pick up; to collect; to gather;  
简介	簡介	jiǎn jiè	summary; brief introduction;  
剑	劍	jiàn, jiàn	variant of 劍|剑[jian4];  
鉴定	鑒定	jiàn dìng	to appraise; to identify; to evaluate;  
箭	箭	jiàn	arrow; CL:支[zhi1];  
将军	將軍	Jiāng jūn, jiāng jūn	Chiangchun township in Tainan county 台南縣|台南县[Tai2 nan2 xian4], Taiwan;  general; high-ranking military officer; to check or checkmate; fig. to embarrass; to challenge; to put sb on the spot;  
讲课	講課	jiǎng kè	teach; lecture;  
酱	醬	jiàng	thick paste of fermented soybean; marinated in soy paste; paste; jam;  
酱油	醬油	jiàng yoú	soy sauce;  
骄傲	驕傲	jiāo ào	pride; arrogance; conceited; proud of sth;  
焦点	焦點	jiāo diǎn	focus; focal point;  
脚印	腳印	jiǎo yìn	footprint;  
觉	覺	jiào, jué	a nap; a sleep; CL:場|场[chang2];  to feel; to find that; thinking; awake; aware;  
教堂	教堂	jiào táng	church; chapel; CL:間|间[jian1];  
教育部	教育部	Jiào yù bù	Ministry of Education;  
接收	接收	jiē shoū	reception (of transmitted signal); to receive; to accept; to admit; to take over (e.g. a factory); to expropriate;  
揭	揭	jiē	to take the lid off; to expose; to unmask;  
街头	街頭	jiē toú	street;  
节	節	jiē, jié	see 節骨眼|节骨眼[jie1 gu5 yan3];  festival; holiday; node; joint; section; segment; part; to economize; to save; to abridge; moral integrity; classifier for segments, e.g. lessons, train wagons, biblical verses; CL:個|个[ge4];  
节假日	節假日	jié jià rì	public holiday;  
节能	節能	jié néng	to save energy; energy-saving;  
节奏	節奏	jié zoù	rhythm; tempo; musical pulse; cadence; beat;  
杰出	傑齣	jié chū	outstanding; distinguished; remarkable; prominent; illustrious;  
截止	截止	jié zhǐ	to close; to stop; to put a stop to sth; cut-off point; stopping point; deadline;  
截至	截至	jié zhì	up to (a time); by (a time);  
解	解	Xiè, jiě, jiè, xiè	surname Xie;  to divide; to break up; to split; to separate; to dissolve; to solve; to melt; to remove; to untie; to loosen; to open; to emancipate; to explain; to understand; to know; a solution; a dissection;  to transport under guard;  acrobatic display (esp. on horseback) (old); variant of 懈[xie4] and 邂[xie4] (old);  
解说	解說	jiě shuō	to explain; to comment;  
界	界	jiè	boundary; scope; extent; circles; group; kingdom (taxonomy);  
界	界	jiè	boundary; scope; extent; circles; group; kingdom (taxonomy);  
借鉴	藉鑒	jiè jiàn	to use other people's experience; to borrow from a source; to use as reference;  
金额	金額	jīn é	sum of money; monetary value;  
金钱	金錢	jīn qián	money; currency;  
金融	金融	jīn róng	banking; finance; financial;  
尽	盡	jǐn, jìn	to the greatest extent; (when used before a noun of location) furthest or extreme; to be within the limits of; to give priority to;  to use up; to exhaust; to end; to finish; to the utmost; exhausted; finished; to the limit (of sth); all; entirely;  
进攻	進攻	jìn gōng	to attack; to assault; to go on the offensive; attack; assault; offense (sports);  
近日	近日	jìn rì	in the past few days; recently; in the last few days;  
近视	近視	jìn shì	shortsighted; nearsighted; myopia;  
惊人	驚人	jīng rén	astonishing;  
惊喜	驚喜	jīng xǐ	nice surprise; to be pleasantly surprised;  
精	精	jīng	essence; extract; vitality; energy; semen; sperm; mythical goblin spirit; highly perfected; elite; the pick of sth; proficient (refined ability); extremely (fine); selected rice (archaic);  
精美	精美	jīng měi	delicate; fine; refinement;  
精品	精品	jīng pǐn	quality goods; premium product; fine work (of art);  
井	井	Jǐng, jǐng	Jing, one of the 28 constellations of Chinese astronomy; surname Jing;  a well; CL:口[kou3]; neat; orderly;  
景	景	Jǐng, jǐng	surname Jing;  bright; circumstance; scenery;  
景点	景點	jǐng diǎn	scenic spot; place of interest (tourism);  
净	淨	jìng, jìng	clean; completely; only; net (income, exports etc); (Chinese opera) painted face male role;  
纠纷	糾紛	jiū fēn	dispute;  
纠正	糾正	jiū zhèng	to correct; to make right;  
酒水	酒水	jiǔ shuǐ	beverage; a drink;  
救命	救命	jiù mìng	to save sb's life; (interj.) Help!; Save me!;  
救援	救援	jiù yuán	to save; to support; to help; to assist;  
救助	救助	jiù zhù	to help sb in trouble; aid; assistance;  
就是说	就是說	jiù shì shuō	in other words; that is;  
就算	就算	jiù suàn	granted that; even if;  
局	局	jú, jú	office; situation; classifier for games: match, set, round etc;  
剧	劇	jù	theatrical work (play, opera, TV series etc); dramatic (change, increase etc); acute; severe;  
据	據	jù, jū, jù, jù	according to; to act in accordance with; to depend on; to seize; to occupy;  see 拮据[jie2 ju1];  
捐	捐	juān	to contribute; to donate; contribution; tax; to abandon;  
捐款	捐款	juān kuǎn	to donate money; to contribute funds; donation; contribution (of money);  
捐赠	捐贈	juān zèng	to contribute (as a gift); to donate; benefaction;  
捐助	捐助	juān zhù	to donate; to offer (aid); contribution; donation;  
决策	決策	jué cè	strategic decision; decision-making; policy decision; to determine policy;  
觉悟	覺悟	jué wù	to come to understand; to realize; consciousness; awareness; Buddhist enlightenment (Sanskrit: cittotpāda);  
绝	絕	jué, jué	variant of 絕|绝[jue2];  
绝大多数	絕大多數	jué dà duō shù	absolute majority; overwhelming majority;  
军队	軍隊	jūn duì	army; troops; CL:支[zhi1],個|个[ge4];  
军舰	軍艦	jūn jiàn	warship; military naval vessel; CL:艘[sou1];  
军事	軍事	jūn shì	military affairs; military matters; military;  
开创	開創	kāi chuàng	to initiate; to start; to found;  
开关	開關	kāi guān	power switch; to open a gate;  
开设	開設	kāi shè	to offer (goods or services); to open (for business etc);  
开通	開通	kāi tong	to open up (windows for air, ideas for discussion, transport routes etc); open-minded;  
开头	開頭	kāi toú	beginning; to start;  
开夜车	開夜車	kāi yè chē	to burn the midnight oil; to work late into the night;  
看	看	kān, kàn	to look after; to take care of; to watch; to guard;  to see; to look at; to read; to watch; to visit; to call on; to consider; to regard as; to look after; to treat (an illness); to depend on; to feel (that); (after verb) to give it a try; Watch out! (for a danger);  
看管	看管	kān guǎn	to look after;  
看得见	看得見	kàn dé jiàn	can see; visible;  
看得起	看得起	kàn de qǐ	to show respect for; to think highly of;  
看好	看好	kàn hǎo	optimistic (about the outcome); bullish; to think highly of; to support;  
看作	看作	kàn zuò	to look upon as; to regard as;  
康复	康復	kāng fù	to recuperate; to recover (health); to convalesce;  
抗议	抗議	kàng yì	to protest; protest;  
考场	考場	kǎo chǎng	exam room;  
考题	考題	kǎo tí	exam question;  
科研	科研	kē yán	(scientific) research;  
客车	客車	kè chē	coach; bus; passenger train;  
肯	肯	kěn, kěn	to agree; to consent; to be ready (to do sth); willing;  
空军	空軍	kōng jūn	air force;  
口试	口試	koǔ shì	oral examination; oral test;  
扣	扣	koù, koù	button;  
酷	酷	kù	ruthless; strong (e.g. of wine); (loanword) cool; hip;  
跨	跨	kuà	to step across; to stride over; to straddle; to span;  
快车	快車	kuài chē	express (train, bus etc);  
宽阔	寬闊	kuān kuò	expansive; wide; width; thickness;  
矿	礦	kuàng, kuàng	variant of 礦|矿[kuang4];  
阔	闊	kuò, kuò	rich; wide; broad;  
啦	啦	lā, la	(onom.) sound of singing, cheering etc; (phonetic); (dialect) to chat;  sentence-final particle, contraction of 了啊, indicating exclamation; particle placed after each item in a list of examples;  
来往	來往	lái wǎng	to come and go; to have dealings with; to be in relation with;  
赖	賴	Lài, lài, lài	surname Lai;  variant of 賴|赖[lai4];  
栏目	欄目	lán mù	regular column or segment (in a publication or broadcast program); program (TV or radio);  
蓝领	藍領	lán lǐng	blue collar; common laborer;  
蓝天	藍天	lán tiān	blue sky;  
懒	懶	lǎn, lǎn	lazy;  
牢	牢	láo	firm; sturdy; fold (for animals); sacrifice; prison;  
老乡	老鄉	lǎo xiāng	fellow townsman; fellow villager; sb from the same hometown;  
冷气	冷氣	lěng qì	air conditioning (Tw);  
冷水	冷水	lěng shuǐ	cold water; unboiled water; fig. not yet ready (of plans);  
礼堂	禮堂	lǐ táng	assembly hall; auditorium; CL:座[zuo4],處|处[chu4];  
理	理	lǐ	texture; grain (of wood); inner essence; intrinsic order; reason; logic; truth; science; natural science (esp. physics); to manage; to pay attention to; to run (affairs); to handle; to put in order; to tidy up;  
理财	理財	lǐ cái	financial management; finance;  
理智	理智	lǐ zhì	reason; intellect; rationality; rational;  
力	力	Lì, lì	surname Li;  power; force; strength; ability; strenuously;  
利	利	Lì, lì	surname Li;  sharp; favorable; advantage; benefit; profit; interest; to do good to; to benefit;  
联盟	聯盟	lián méng	alliance; union; coalition;  
联赛	聯賽	lián sài	(sports) league; league tournament;  
联手	聯手	lián shoǔ	lit. to join hands; to act together;  
凉鞋	涼鞋	liáng xié	sandal;  
两侧	兩側	liǎng cè	two sides; both sides;  
两手	兩手	liǎngshǒu	Two hands
聊	聊	liáo	to chat; to depend upon (literary); temporarily; just; slightly;  
聊天儿	聊天兒	liao2 tian1 r5	erhua variant of 聊天[liao2 tian1];  
料	料	liào	material; stuff; grain; feed; to expect; to anticipate; to guess;  
料	料	liào	material; stuff; grain; feed; to expect; to anticipate; to guess;  
裂	裂	liè	to split; to crack; to break open; to rend;  
灵活	靈活	líng huó	flexible; nimble; agile;  
领取	領取	lǐng qǔ	to receive; to draw; to get;  
领袖	領袖	lǐng xiù	leader; CL:個|个[ge4],位[wei4],名[ming2];  
另	另	lìng	other; another; separate; separately;  
留言	留言	liú yán	to leave a message; to leave one's comments; message;  
流感	流感	liú gǎn	flu; influenza;  
楼道	樓道	loú dào	corridor; passageway (in storied building);  
楼房	樓房	loú fáng	a building of two or more stories; CL:棟|栋[dong4],幢[zhuang4],座[zuo4];  
露	露	Lù, loù, lù	surname Lu;  to show; to reveal; to betray; to expose;  dew; syrup; nectar; outdoors (not under cover); to show; to reveal; to betray; to expose;  
陆军	陸軍	lù jūn	army;  
录像	錄像	lù xiàng	to videotape; to videorecord; video recording; CL:盤|盘[pan2];  
录音机	錄音機	lù yīn jī	(tape) recording machine; tape recorder; CL:臺|台[tai2];  
路过	路過	lù guò	to pass by or through;  
露	露	Lù, loù, lù	surname Lu;  to show; to reveal; to betray; to expose;  dew; syrup; nectar; outdoors (not under cover); to show; to reveal; to betray; to expose;  
旅店	旅店	lǚ diàn	inn; small hotel;  
绿化	綠化	lǜ huà	to make green with plants; to reforest;  
马车	馬車	mǎ chē	cart; chariot; carriage; buggy;  
嘛	嘛	ma	modal particle indicating that sth is obvious; particle indicating a pause for emphasis;  
埋	埋	mái, mán	to bury;  to blame;  
馒头	饅頭	mán tou	steamed roll; steamed bun; steamed bread; CL:個|个[ge4];  
慢车	慢車	màn chē	local bus or train; slow train with many stops;  
盲人	盲人	máng rén	blind person;  
梅花	梅花	méi huā	plum blossom; clubs ♣ (a suit in card games); wintersweet (dialect);  
美容	美容	měi róng	to improve one's appearance (using cosmetics or cosmetic surgery); to make oneself more attractive; to beautify;  
蒙	濛	méng, mēng, méng, Méng, Měng, mēng, méng	to cover; ignorant; to suffer (misfortune); to receive (a favor); to cheat;  (knocked) unconscious; dazed; stunned;  surname Meng;  Mongol ethnic group; abbr. for Mongolia 蒙古國|蒙古国[Meng3 gu3 guo2]; Taiwan pr. [Meng2];  
蒙	濛	méng, mēng, méng, Méng, Měng, mēng, méng	to cover; ignorant; to suffer (misfortune); to receive (a favor); to cheat;  (knocked) unconscious; dazed; stunned;  surname Meng;  Mongol ethnic group; abbr. for Mongolia 蒙古國|蒙古国[Meng3 gu3 guo2]; Taiwan pr. [Meng2];  
猛	猛	měng	ferocious; fierce; violent; brave; suddenly; abrupt; (slang) awesome;  
棉	棉	mián	generic term for cotton or kapok; cotton; padded or quilted with cotton;  
免得	免得	miǎn de	so as not to; so as to avoid;  
面对面	麵對麵	miàn duì miàn	face to face;  
面向	麵嚮	miàn xiàng	to face; to turn towards; to incline to; geared towards; catering for; -oriented; facial feature; appearance; aspect; facet;  
妙	妙	miào, miào	variant of 妙[miao4];  
灭	滅	miè	to extinguish or put out; to go out (of a fire etc); to exterminate or wipe out; to drown;  
民歌	民歌	mín gē	folk song; CL:支[zhi1],首[shou3];  
民工	民工	mín gōng	migrant worker; temporary worker enlisted on a public project;  
民警	民警	mín jǐng	civil police; PRC police; abbr. for 人民警察;  
民意	民意	mín yì	public opinion; popular will; public will;  
民主	民主	mín zhǔ	democracy;  
名额	名額	míng é	quota; number of places; place (in an institution, a group etc);  
名胜	名勝	míng shèng	a place famous for its scenery or historical relics; scenic spot; CL:處|处[chu4];  
名义	名義	míng yì	name; titular; nominal; in name; ostensible purpose;  
名誉	名譽	míng yù	fame; reputation; honor; honorary; emeritus (of retired professor);  
明日	明日	míng rì	tomorrow;  
命	命	mìng	life; fate; order or command; to assign a name, title etc;  
膜	膜	mó	membrane; film;  
磨	磨	mó, mò	to rub; to grind; to polish; to sharpen; to wear down; to die out; to waste time; to pester; to insist;  grindstone; to grind; to turn round;  
没收	沒收	mò shoū	to confiscate; to seize;  
墨水	墨水	mò shuǐ	ink; CL:瓶[ping2];  
母	母	mǔ	mother; elderly female relative; origin; source; (of animals) female;  
母鸡	母雞	mǔ jī	hen;  
母女	母女	mǔ nǚ	mother-daughter;  
母子	母子	mǔ zǐ	mother and child; parent and subsidiary (companies); principal and interest;  
墓	墓	mù	grave; tomb; mausoleum;  
拿走	拿走	ná zoǔ	to take away;  
奶粉	奶粉	nǎi fěn	powdered milk;  
奶牛	奶牛	nǎi niú	milk cow; dairy cow;  
难忘	難忘	nán wàng	unforgettable;  
内地	內地	Nèi dì, nèi dì	mainland China (PRC excluding Hong Kong and Macau, but including islands such as Hainan); Japan (used in Taiwan during Japanese colonization);  inland; interior; hinterland;  
内外	內外	nèi wài	inside and outside; domestic and foreign; approximately; about;  
内衣	內衣	nèi yī	undergarment; underwear; CL:件[jian4];  
能否	能否	néng foǔ	whether or not; can it or can't it; is it possible?;  
泥	泥	ní, nì	mud; clay; paste; pulp;  restrained;  
扭	扭	niǔ	to turn; to twist; to wring; to sprain; to swing one's hips;  
排行榜	排行榜	pái háng bǎng	the charts (of best-sellers); table of ranking;  
派出	派齣	pài chū	to send; to dispatch;  
判	判	pàn	to judge; to sentence; to discriminate; to discern; obviously (different);  
盼望	盼望	pàn wàng	to hope for; to look forward to;  
泡	泡	pāo, pào	puffed; swollen; spongy; small lake (esp. in place names); classifier for urine or feces;  bubble; foam; blister (i.e. skin bubble); to soak; to steep; to infuse; to dawdle; to shilly-shally; to hang about; to pick up (a girl); to get off with (a sexual partner); classifier for occurrences of an action; classifier for number of infusions;  
炮	炮	bāo, páo, pào, pào	to sauté; to fry; to dry by heating;  to prepare herbal medicine by roasting or parching (in a pan);  variant of 炮[pao4];  
陪同	陪同	péi tóng	to accompany;  
配置	配置	pèi zhì	to deploy; to allocate; configuration; allocation;  
皮球	皮球	pí qiú	ball (made of rubber, leather etc);  
偏	偏	piān	to lean; to slant; oblique; prejudiced; to deviate from average; to stray from the intended line; stubbornly; contrary to expectations; left-hand side of a split Chinese character, often the key or radical;  
贫困	貧睏	pín kùn	impoverished; poverty;  
品牌	品牌	pǐn pái	brand name; trademark;  
聘请	聘請	pìn qǐng	to engage; to hire (a lawyer etc);  
平凡	平凡	píng fán	commonplace; ordinary; mediocre;  
平方米	平方米	píng fāng mǐ	square meter;  
平衡	平衡	píng héng	balance; equilibrium;  
平台	平颱	píng tái	platform; terrace; flat-roofed building;  
评	評	píng	to discuss; to comment; to criticize; to judge; to choose (by public appraisal);  
评选	評選	píng xuǎn	to select on the basis of a vote or consensus;  
屏幕	屏幕	píng mù	screen (TV, computer or movie);  
坡	坡	pō	slope; CL:個|个[ge4]; sloping; slanted;  
扑	撲	pū	to throw oneself at; to pounce on; to devote one's energies; to flap; to flutter; to dab; to pat; to bend over;  
铺	鋪	pù, pū, pù	plank bed; place to sleep; shop; store; (old) relay station;  to spread; to display; to set up; (old) holder for door-knocker;  
欺负	欺負	qī fu	to bully;  
奇妙	奇妙	qí miào	fantastic; wonderful;  
企图	企圖	qǐ tú	to attempt; to try; attempt; CL:種|种[zhong3];  
起点	起點	qǐ diǎn	starting point;  
起诉	起訴	qǐ sù	to sue; to bring a lawsuit against; to prosecute;  
气氛	氣氛	qì fēn	atmosphere; mood;  
恰当	恰當	qià dàng	appropriate; suitable;  
恰好	恰好	qià hǎo	as it turns out; by lucky coincidence; (of number, time, size etc) just right;  
恰恰	恰恰	qià qià	exactly; just; precisely;  
牵	牽	qiān	to lead along; to pull (an animal on a tether); (bound form) to involve; to draw in;  
铅笔	鉛筆	qiān bǐ	(lead) pencil; CL:支[zhi1],枝[zhi1],桿|杆[gan3];  
谦虚	謙虛	qiān xū	modest; self-effacing; to make modest remarks;  
前方	前方	qián fāng	ahead; the front;  
前来	前來	qián lái	to come (formal); before; previously;  
潜力	潛力	qián lì	potential; capacity;  
强盗	強盜	qiáng dào	to rob (with force); bandit; robber; CL:個|个[ge4];  
强化	強化	qiáng huà	to strengthen; to intensify;  
强势	強勢	qiáng shì	strong; powerful; (linguistics) emphatic; intensive;  
强壮	強壯	qiáng zhuàng	strong; sturdy; robust;  
桥梁	橋梁	qiáo liáng	bridge; fig. connection between two areas;  
巧妙	巧妙	qiǎo miào	ingenious; clever; ingenuity; artifice;  
茄子	茄子	qié zi	eggplant (Solanum melongena L.); aubergine; brinjal; Guinea squash; phonetic 'cheese' (when being photographed); equivalent of 'say cheese';  
切实	切實	qiè shí	feasible; realistic; practical; earnestly; conscientiously;  
侵犯	侵犯	qīn fàn	to infringe on; to encroach on; to violate; to assault;  
亲属	親屬	qīn shǔ	kin; kindred; relatives;  
亲眼	親眼	qīn yǎn	with one's own eyes; personally;  
倾向	傾嚮	qīng xiàng	trend; tendency; orientation;  
清	清	Qīng, qīng	Qing or Ch'ing dynasty of Imperial China (1644-1911); surname Qing;  clear; distinct; quiet; just and honest; pure; to settle or clear up; to clean up or purge;  
清洁	清潔	qīng jié	clean; to clean;  
清洁工	清潔工	qīng jié gōng	cleaner; janitor; garbage collector;  
清明节	清明節	Qīng míng jié	Qingming or Pure Brightness Festival or Tomb Sweeping Day, celebration for the dead (in early April);  
清洗	清洗	qīng xǐ	to wash; to clean; to purge;  
情绪	情緒	qíng xù	mood; state of mind; moodiness; CL:種|种[zhong3];  
求职	求職	qiú zhí	to seek employment;  
球拍	球拍	qiú pāi	racket;  
球星	球星	qiú xīng	sports star (ball sport);  
球员	球員	qiú yuán	sports club member; footballer, golfer etc;  
区分	區分	qū fēn	to differentiate; to draw a distinction; to divide into categories;  
渠道	渠道	qú dào	irrigation ditch; (fig.) channel; means;  
取款	取款	qǔ kuǎn	to withdraw money from a bank;  
取款机	取款機	qǔ kuǎn jī	ATM;  
去掉	去掉	qù diào	to get rid of; to exclude; to eliminate; to remove; to delete; to strip out; to extract;  
权	權	Quán, quán	surname Quan;  authority; power; right; (literary) to weigh; expedient; temporary;  
权力	權力	quán lì	power; authority;  
全力	全力	quán lì	with all one's strength; full strength; all-out (effort); fully (support);  
全新	全新	quán xīn	all new; completely new;  
券	券	quàn, quàn	variant of 券[quan4];  
缺陷	缺陷	quē xiàn	defect; flaw; physical defect;  
却是	卻是	què shì	nevertheless; actually; the fact is ...;  
让座	讓座	ràng zuò	to give up one's seat for sb;  
热点	熱點	rè diǎn	hot spot; point of special interest;  
热水	熱水	rè shuǐ	hot water;  
热水器	熱水器	rè shuǐ qì	water heater;  
热线	熱綫	rè xiàn	hotline (communications link);  
人权	人權	rén quán	human rights;  
认同	認同	rèn tóng	to approve of; to endorse; to acknowledge; to recognize; to identify oneself with;  
日夜	日夜	rì yè	day and night; around the clock;  
日语	日語	Rì yǔ	Japanese language;  
融合	融閤	róng hé	a mixture; an amalgam; fusion; welding together; to be in harmony with (nature); to harmonize with; to fit in;  
融入	融入	róng rù	to blend into; to integrate; to assimilate; to merge;  
如	如	rú	as; as if; such as;  
如一	如一	rúyī	As one
乳制品	乳製品	rǔ zhì pǐn	dairy products;  
入	入	rù	to enter; to go into; to join; to become a member of; to confirm or agree with; abbr. for 入聲|入声[ru4 sheng1];  
入学	入學	rù xué	to enter a school or college; to go to school for the first time as a child;  
若	若	ruò	to seem; like; as; if;  
塞	塞	Sāi, sāi, sài, sè	Serbia; Serbian; abbr. for 塞爾維亞|塞尔维亚[Sai1 er3 wei2 ya4];  to stop up; to squeeze in; to stuff; cork; stopper;  strategic pass; tactical border position;  to stop up; to stuff; to cope with;  
赛	賽	sài	to compete; competition; match; to surpass; better than; superior to; to excel;  
赛场	賽場	sài chǎng	racetrack; field (for athletics competition);  
三明治	三明治	sān míng zhì	sandwich (loanword); CL:個|个[ge4];  
丧失	喪失	sàng shī	to lose; to forfeit;  
山峰	山峰	shān fēng	(mountain) peak;  
山谷	山榖	shān gǔ	valley; ravine;  
山坡	山坡	shān pō	hillside;  
伤口	傷口	shāng koǔ	wound; cut;  
伤亡	傷亡	shāng wáng	casualties; injuries and deaths;  
伤员	傷員	shāng yuán	wounded person;  
商城	商城	Shāng chéng, shāng chéng	see 商城縣|商城县[Shang1 cheng2 xian4];  shopping center; department store;  
上当	上當	shàng dàng	taken in (by sb's deceit); to be fooled; to be duped;  
上帝	上帝	Shàng dì	God;  
上市	上市	shàng shì	to hit the market (of a new product); to float (a company on the stock market);  
上台	上颱	shàng tái	to rise to power (in politics); to go on stage (in the theater);  
上演	上演	shàng yǎn	to screen (a movie); to stage (a play); a screening; a staging;  
勺	勺	sháo	spoon; ladle; CL:把[ba3]; abbr. for 公勺[gong1 shao2], centiliter (unit of volume);  
少儿	少兒	shào ér	child;  
舌头	舌頭	shé tou	tongue; CL:個|个[ge4]; enemy soldier captured for the purpose of extracting information;  
设计师	設計師	shè jì shī	designer; architect;  
涉及	涉及	shè jí	to involve; to touch upon (a topic);  
深化	深化	shēn huà	to deepen; to intensify;  
深深	深深	shēn shēn	deep; profound;  
审查	審查	shěn chá	to examine; to investigate; to censor out; censorship;  
升级	升級	shēng jí	to escalate (in intensity); to go up by one grade; to be promoted; to upgrade (computing);  
升学	升學	shēng xué	to enter the next grade school;  
升值	升值	shēng zhí	to rise in value; to appreciate;  
生活费	生活費	shēng huó fèi	cost of living; living expenses; alimony;  
省钱	省錢	shěng qián	to save money;  
圣诞节	聖誕節	Shèng dàn jié	Christmas time; Christmas season; Christmas;  
盛行	盛行	shèng xíng	to be in vogue; to be prevalent;  
师父	師父	shī fu	used for 師傅|师傅 (in Taiwan); master; qualified worker;  
师生	師生	shī shēng	teachers and students;  
时而	時而	shí ér	occasionally; from time to time;  
时节	時節	shí jié	season; time;  
时期	時期	shí qī	period; phase; CL:個|个[ge4];  
时时	時時	shí shí	often; constantly;  
时装	時裝	shí zhuāng	fashion; fashionable clothes;  
识	識	shí, zhì	to know; knowledge; Taiwan pr. [shi4];  to record; to write a footnote;  
识字	識字	shí zì	to learn to read;  
实践	實踐	shí jiàn	practice; to put into practice; to live up to (a promise); to carry out (a project);  
食欲	食欲	shí yù	appetite;  
市民	市民	shì mín	city resident;  
事后	事後	shì hoù	after the event; in hindsight; in retrospect;  
试点	試點	shì diǎn	test point; to carry out trial; pilot scheme;  
适当	適當	shì dàng	suitable; appropriate;  
收藏	收藏	shoū cáng	to hoard; to collect; collection; to bookmark (Internet);  
收取	收取	shoū qǔ	to receive; to collect;  
收养	收養	shoū yǎng	to take in and care for (an elderly person, a dog etc); to adopt (a child); adoption;  
手续费	手續費	shoǔ xù fèi	service charge; processing fee; commission;  
首	首	shoǔ	head; chief; first (occasion, thing etc); classifier for poems, songs etc;  
首次	首次	shoǔ cì	first; first time; for the first time;  
首脑	首腦	shoǔ nǎo	head (of state); summit (meeting); leader;  
首席	首席	shoǔ xí	chief (representative, correspondent etc);  
首相	首相	shoǔ xiàng	prime minister (of Japan or UK etc);  
书房	書房	shū fáng	study (room); studio; CL:間|间[jian1];  
薯片	薯片	shǔ piàn	fried potato chips;  
薯条	薯條	shǔ tiáo	french fries; french fried potatoes; chips;  
双打	雙打	shuāng dǎ	doubles (in sports); CL:場|场[chang3];  
爽	爽	shuǎng	bright; clear; crisp; open; frank; straightforward; to feel well; fine; pleasurable; invigorating; to deviate;  
水泥	水泥	shuǐ ní	cement; CL:袋[dai4];  
税	稅	shuì	taxes; duties;  
顺	順	shùn	to obey; to follow; to arrange; to make reasonable; along; favorable;  
说明书	說明書	shuō míng shū	(technical) manual; (book of) directions; synopsis (of a play or film); specification (patent); CL:本[ben3];  
说实话	說實話	shuō shí huà	to speak the truth; truth to tell; frankly;  
司长	司長	sī zhǎng	bureau chief;  
死亡	死亡	sǐ wáng	to die; death;  
四处	四處	sì chù	all over the place; everywhere and all directions;  
寺	寺	sì	Buddhist temple; mosque; government office (old);  
送礼	送禮	sòng lǐ	to give a present;  
送行	送行	sòng xíng	to see someone off; to throw someone a send-off party;  
素质	素質	sù zhì	inner quality; basic essence;  
算了	算瞭	suàn le	let it be; let it pass; forget about it;  
算是	算是	suàn shì	considered to be; at last;  
虽	雖	suī	although; even though;  
岁数	歲數	suì shu	age (number of years old);  
所	所	suǒ	actually; place; classifier for houses, small buildings, institutions etc; that which; particle introducing a relative clause or passive; CL:個|个[ge4];  
踏实	踏實	tā shi	firmly-based; steady; steadfast; to have peace of mind; free from anxiety; Taiwan pr. [ta4 shi2];  
塔	塔	tǎ, tǎ	old variant of 塔[ta3];  
踏	踏	tā, tà	see 踏實|踏实[ta1 shi5];  to tread; to stamp; to step on; to press a pedal; to investigate on the spot;  
台灯	颱燈	tái dēng	desk lamp; table lamp;  
太阳能	太陽能	tài yáng néng	solar energy;  
叹气	嘆氣	tàn qì	to sigh; to heave a sigh;  
探索	探索	tàn suǒ	to explore; to probe;  
探讨	探討	tàn tǎo	to investigate; to probe;  
趟	趟	tāng, tāng, tàng	to wade; to trample; to turn the soil;  classifier for times, round trips or rows; a time; a trip;  
掏	掏	tāo, tāo	variant of 掏[tao1];  
特	特	tè	special; unique; distinguished; especially; unusual; very;  
特大	特大	tèdà	Extraordinary
特地	特地	tè dì	specially; for a special purpose;  
特快	特快	tè kuài	express (train, delivery etc);  
特意	特意	tè yì	specially; intentionally;  
疼痛	疼痛	téng tòng	pain; ache; sore;  
踢	踢	tī	to kick; to play (e.g. soccer);  
提交	提交	tí jiāo	to submit (a report etc); to refer (a problem) to sb;  
提升	提升	tí shēng	to promote; to upgrade;  
天然	天然	tiān rán	natural;  
天堂	天堂	tiān táng	paradise; heaven;  
天下	天下	tiān xià	land under heaven; the whole world; the whole of China; realm; rule;  
添	添	tiān	to add; to increase; to replenish;  
田	田	Tián, tián	surname Tian;  field; farm; CL:片[pian4];  
田径	田徑	tián jìng	track and field (athletics);  
跳水	跳水	tiào shuǐ	to dive (into water); (sports) diving; to commit suicide by jumping into water; (fig.) (of stock prices etc) to fall dramatically;  
听取	聽取	tīng qǔ	to hear (news); to listen to;  
通报	通報	tōng bào	to inform; to notify; to announce; circular; bulletin; (scientific) journal;  
通道	通道	Tōng dào, tōng dào	Tongdao Dong autonomous county in Huaihua 懷化|怀化[Huai2 hua4], Hunan;  (communications) channel; thoroughfare; passage;  
通红	通紅	tōng hóng	very red; red through and through; to blush (deep red);  
通话	通話	tōng huà	to hold a conversation; to talk over the telephone; phone call;  
通行	通行	tōng xíng	to go through; a passage through; in general use; a pass or laissez-passer; a license (to a computer account);  
通讯	通訊	tōng xùn	communications; news story; dispatch; CL:個|个[ge4];  
同	同	tóng, tóng, tòng	like; same; similar; together; alike; with;  see 衚衕|胡同[hu2 tong4];  
同胞	同胞	tóng bāo	born of the same parents; sibling; fellow citizen; compatriot;  
同行	同行	tóng háng, tóng xíng	person of the same profession; of the same trade, occupation or industry;  to journey together;  
同期	同期	tóng qī	the corresponding time period (in a different year etc); concurrent; synchronous;  
同一	同一	tóng yī	identical; the same;  
铜牌	銅牌	tóng pái	bronze medal; bronze plaque bearing a business name or logo etc; CL:枚[mei2];  
头疼	頭疼	toú téng	headache;  
投票	投票	toú piào	to vote; vote;  
透露	透露	toù lù	to leak out; to divulge; to reveal;  
图书	圖書	tú shū	books (in a library or bookstore); CL:本[ben3],冊|册[ce4],部[bu4];  
徒弟	徒弟	tú dì	apprentice; disciple;  
途径	途徑	tú jìng	way; channel;  
土	土	Tǔ, tǔ	Tu (ethnic group); surname Tu;  earth; dust; clay; local; indigenous; crude opium; unsophisticated; one of the eight ancient musical instruments 八音[ba1 yin1];  
团队	團隊	tuán duì	team;  
推出	推齣	tuī chū	to push out; to release; to launch; to publish; to recommend;  
退票	退票	tuì piào	to bounce (a check); to return a ticket; ticket refund;  
吞	吞	tūn	to swallow; to take;  
托	托	tuō, tuō	to trust; to entrust; to be entrusted with; to act as trustee;  
拖	拖	tuō, tuō	to drag; to tow; to trail; to hang down; to mop (the floor); to delay; to drag on;  
拖鞋	拖鞋	tuō xié	slippers; sandals; flip-flops; CL:雙|双[shuang1],隻|只[zhi1];  
挖	挖	wā	to dig; to excavate; to scoop out;  
娃娃	娃娃	wá wa	baby; small child; doll;  
哇	哇	wā, wa	Wow!; sound of child's crying; sound of vomiting;  replaces 啊[a5] when following the vowel 'u' or 'ao';  
外币	外幣	wài bì	foreign currency;  
外部	外部	wài bù	external part; external;  
外出	外齣	wài chū	to go out; to go away (on a trip etc);  
外观	外觀	wài guān	exterior appearance; to view sth from the outside; exterior condition;  
外科	外科	wài kē	surgery (branch of medicine);  
外来	外來	wài lái	external; foreign; outside;  
外头	外頭	wài tou	outside; out;  
外衣	外衣	wài yī	outer clothing; semblance; appearance;  
外资	外資	wài zī	foreign investment;  
弯曲	彎麯	wān qū	to bend; to curve around; curved; crooked; to wind; to warp;  
顽皮	頑皮	wán pí	naughty;  
顽强	頑強	wán qiáng	tenacious; hard to defeat;  
王后	王後	wáng hoù	queen; CL:個|个[ge4],位[wei4];  
王子	王子	wáng zǐ	prince; son of a king;  
网吧	網吧	wǎng bā	Internet café;  
网页	網頁	wǎng yè	web page;  
往后	往後	wǎng hoù	from now on; in the future; time to come;  
往来	往來	wǎng lái	dealings; contacts; to go back and forth;  
往年	往年	wǎng nián	in former years; in previous years;  
望见	望見	wàng jiàn	to espy; to spot;  
危机	危機	wēi jī	crisis; CL:個|个[ge4];  
威胁	威脅	wēi xié	to threaten; to menace;  
微波炉	微波爐	wēi bō lú	microwave oven; CL:臺|台[tai2];  
维生素	維生素	wéi shēng sù	vitamin;  
为此	為此	wèi cǐ	for this reason; with regards to this; in this respect; in order to do this; to this end;  
为何	為何	wèi hé	why;  
文娱	文娛	wén yú	cultural recreation; entertainment;  
卧铺	臥鋪	wò pù	a bed (on a train); a couchette;  
乌云	烏雲	wū yún	black cloud;  
无边	無邊	wú biān	without boundary; not bordered;  
无关	無關	wú guān	unrelated; having nothing to do (with sth else);  
无效	無效	wú xiào	not valid; ineffective; in vain;  
舞蹈	舞蹈	wǔ dǎo	dance (performance art); dancing;  
物品	物品	wù pǐn	articles; goods; materials;  
误	誤	wù	mistake; error; to miss; to harm; to delay; to neglect; mistakenly;  
西班牙语	西班牙語	Xī bān yá yǔ	Spanish language;  
吸毒	吸毒	xī dú	to take drugs;  
牺牲	犧牲	xī shēng	to sacrifice one's life; to sacrifice (sth valued); beast slaughtered as a sacrifice;  
洗衣粉	洗衣粉	xǐ yī fěn	laundry detergent; washing powder;  
戏曲	戲麯	xì qǔ	Chinese opera;  
细胞	細胞	xì bāo	cell (biology);  
细菌	細菌	xì jūn	bacterium; germ;  
先锋	先鋒	xiān fēng	vanguard; pioneer;  
嫌	嫌	xián	to dislike; suspicion; resentment; enmity; abbr. for 嫌犯[xian2 fan4], criminal suspect;  
显出	顯齣	xiǎn chū	to express; to exhibit;  
险	險	xiǎn	danger; dangerous; rugged;  
线路	綫路	xiàn lù	line; circuit; wire; road; railway track; bus route;  
陷入	陷入	xiàn rù	to sink into; to get caught up in; to land in (a predicament);  
响声	響聲	xiǎng shēng	noise;  
想不到	想不到	xiǎng bu dào	unexpected; hard to imagine; it had not occurred to me; who could have thought that;  
消耗	消耗	xiāo hào	to use up; to consume;  
消灭	消滅	xiāo miè	to put an end to; to annihilate; to cause to perish; to perish; annihilation (in quantum field theory);  
小费	小費	xiǎo fèi	tip; gratuity;  
小麦	小麥	xiǎo mài	wheat; CL:粒[li4];  
小于	小於	xiǎo yú	less than, <;  
晓得	曉得	xiǎo de	to know;  
笑脸	笑臉	xiào liǎn	smiling face; smiley :) ☺; CL:副[fu4];  
笑容	笑容	xiào róng	smile; smiling expression; CL:副[fu4];  
笑声	笑聲	xiào shēng	laughter;  
协会	協會	xié huì	an association; a society; CL:個|个[ge4],家[jia1];  
协商	協商	xié shāng	to consult with; to talk things over; agreement;  
协调	協調	xié tiáo	to coordinate; to harmonize; to fit together; to match (colors etc); harmonious; concerted;  
协助	協助	xié zhù	to provide assistance; to aid;  
写字楼	寫字樓	xiě zì loú	office building;  
写字台	寫字颱	xiě zì tái	writing desk;  
心灵	心靈	xīn líng	bright; smart; quick-witted; heart; thoughts; spirit;  
心愿	心願	xīn yuàn	cherished desire; dream; craving; wish; aspiration;  
心脏	心髒	xīn zàng	heart; CL:顆|颗[ke1],個|个[ge4];  
心脏病	心髒病	xīn zàng bìng	heart disease;  
新人	新人	xīn rén	new age person; new type of person; newly-wed, esp. new bride; bride and groom;  
新兴	新興	Xīn xīng, xīn xīng	Xinxing county in Yunfu 雲浮|云浮[Yun2 fu2], Guangdong; Xinxing or Hsinhsing district of Kaohsiung city 高雄市[Gao1 xiong2 shi4], south Taiwan;  new; up-and-coming; newly developing; rising;  
薪水	薪水	xīn shuǐ	salary; wage;  
信仰	信仰	xìn yǎng	to believe in (a religion); firm belief; conviction;  
信用	信用	xìn yòng	to trust; credit (commerce); trustworthiness; creditworthiness;  
兴旺	興旺	xīng wàng	prosperous; thriving; to prosper; to flourish;  
行程	行程	xíng chéng	journey; course of a journey; distance traveled; trajectory; itinerary; route; course (of history);  
形	形	xíng	to appear; to look; form; shape;  
凶	凶	xiōng, xiōng	vicious; fierce; ominous; inauspicious; famine; variant of 兇|凶[xiong1];  
凶手	凶手	xiōng shoǔ	murderer; assassin;  
修车	修車	xiū chē	to repair a bike (car etc);  
袖珍	袖珍	xiù zhēn	pocket-sized; pocket (book etc);  
悬	懸	xuán	to hang or suspend; to worry; public announcement; unresolved; baseless; without foundation;  
旋转	鏇轉	xuán zhuǎn	to rotate; to revolve; to spin; to whirl;  
选拔	選拔	xuǎn bá	to select the best;  
选举	選舉	xuǎn jǔ	to elect; election; CL:次[ci4],個|个[ge4];  
学会	學會	xué huì	to learn; to master; institute; learned society; (scholarly) association;  
学员	學員	xué yuán	student; member of an institution of learning; officer cadet;  
血管	血管	xuè guǎn	vein; artery; CL:根[gen1];  
血液	血液	xuè yè	blood;  
循环	循環	xún huán	to cycle; to circulate; circle; loop;  
压迫	壓迫	yā pò	to oppress; to repress; to constrict; oppression; stress (physics);  
烟花	煙花	yān huā	fireworks; prostitute (esp. in Yuan theater);  
沿	沿	yán	along; to follow (a line, tradition etc); to carry on; to trim (a border with braid, tape etc); border; edge;  
沿海	沿海	yán hǎi	coastal;  
沿着	沿著	yán zhe	to go along; to follow;  
研发	研發	yán fā	research and development; to develop;  
眼看	眼看	yǎn kàn	soon; in a moment; to look on as sth happens;  
演奏	演奏	yǎn zoù	to perform on a musical instrument;  
宴会	宴會	yàn huì	banquet; feast; dinner party; CL:席[xi2],個|个[ge4];  
洋	洋	yáng	ocean; vast; foreign; silver dollar or coin;  
仰	仰	Yǎng, yǎng	surname Yang;  to face upward; to look up; to admire; to rely on;  
养老	養老	yǎng lǎo	to provide for the elderly (family members); to enjoy a life in retirement;  
氧气	氧氣	yǎng qì	oxygen;  
样	樣	yàng	manner; pattern; way; appearance; shape; classifier: kind, type;  
药品	藥品	yào pǐn	medicaments; medicine; drug;  
要不然	要不然	yào bù rán	otherwise; or else; or;  
要好	要好	yào hǎo	to be on good terms; to be close friends; striving for self-improvement;  
要么	要麼	yào me	or; either one or the other;  
要素	要素	yào sù	essential factor; key constituent;  
野	野	yě, yě, yě	field; plain; open space; limit; boundary; rude; feral;  
野生	野生	yě shēng	wild; undomesticated;  
医药	醫藥	yī yào	medical care and medicines; medicine (drug); medical; pharmaceutical;  
依次	依次	yī cì	in order; in succession;  
依赖	依賴	yī lài	to depend on; to be dependent on;  
一次性	一次性	yī cì xìng	one-off (offer); one-time; single-use; disposable (goods);  
一代	一代	yī dài	generation;  
一道	一道	yī dào	together;  
一贯	一貫	yī guàn	consistent; constant; from start to finish; all along; persistent;  
一路上	一路上	yīlùshàng	All the way
仪器	儀器	yí qì	instrument; apparatus; CL:臺|台[tai2];  
仪式	儀式	yí shì	ceremony;  
遗憾	遺憾	yí hàn	regret; to regret; to be sorry that;  
一番	一番	yīfān	Some
一模一样	一模一樣	yī mú yī yàng	exactly the same (idiom); carbon copy; also pr. [yi1 mo2 yi1 yang4];  
一齐	一齊	yī qí	at the same time; simultaneously;  
一时	一時	yī shí	a period of time; a while; for a short while; temporary; momentary; at the same time;  
一同	一同	yī tóng	along; together;  
一行	一行	yī xíng	party; delegation;  
艺人	藝人	yì rén	performing artist; actor;  
议题	議題	yì tí	topic of discussion; topic; subject; issue (under discussion); CL:項|项[xiang4];  
异常	異常	yì cháng	exceptional; abnormal; an anomaly;  
意想不到	意想不到	yì xiǎng bù dào	unexpected; previously unimagined;  
意愿	意願	yì yuàn	aspiration; wish (for); desire;  
因	因	yīn, yīn	cause; reason; because;  
因素	因素	yīn sù	element; factor; CL:個|个[ge4];  
阴谋	陰謀	yīn moú	plot; conspiracy;  
阴影	陰影	yīn yǐng	(lit. and fig.) shadow;  
音量	音量	yīn liàng	sound volume;  
音像	音像	yīn xiàng	audio and video; audiovisual;  
隐藏	隱藏	yǐn cáng	to hide; to conceal; to mask; to shelter; to harbor (i.e. keep sth hidden); to hide oneself; to lie low; to nestle; hidden; implicit; private; covert; recessed (lighting);  
隐私	隱私	yǐn sī	secrets; private business; privacy;  
印	印	Yìn, yìn	surname Yin; abbr. for 印度[Yin4 du4];  to print; to mark; to engrave; a seal; a print; a stamp; a mark; a trace; image;  
英雄	英雄	yīng xióng	hero; CL:個|个[ge4];  
迎来	迎來	yínglái	Ushered
影迷	影迷	yǐng mí	film enthusiast; movie fan; CL:個|个[ge4];  
影星	影星	yǐng xīng	film star;  
应对	應對	yìng duì	response; to answer; to reply;  
应急	應急	yìng jí	to respond to an emergency; to meet a contingency; (attributive) emergency;  
用处	用處	yòng chu	usefulness; CL:個|个[ge4];  
用得着	用得著	yòng de zháo	to be able to use; useable; to have a use for sth; (in interrogative sentence) to be necessary to;  
用法	用法	yòng fǎ	usage;  
用品	用品	yòng pǐn	articles for use; products; goods;  
用心	用心	yòng xīn	motive; intention; to be diligent or attentive; careful;  
优质	優質	yoū zhì	excellent quality;  
游人	遊人	yoú rén	a tourist;  
游玩	遊玩	yoú wán	to amuse oneself; to have fun; to go sightseeing; to take a stroll;  
游戏机	遊戲機	yoú xì jī	video game; game machine;  
游行	遊行	yoú xíng	march; parade; demonstration;  
有关	有關	yoǔ guān	to have sth to do with; to relate to; related to; to concern; concerning;  
有没有	有沒有	yǒuméiyǒu	Do you have
有事	有事	yoǔ shì	to be occupied with sth; to have sth on one's mind; there is something the matter;  
于	於	Yú, yú, yú	surname Yu;  in; at; to; from; by; than; out of;  
娱乐	娛樂	yú lè	to entertain; to amuse; entertainment; recreation; amusement; hobby; fun; joy;  
愉快	愉快	yú kuài	cheerful; cheerily; delightful; pleasant; pleasantly; pleasing; happy; delighted;  
与	與	yú, yǔ, yù	variant of 歟|欤[yu2];  and; to give; together with;  to take part in;  
宇航员	宇航員	yǔ háng yuán	astronaut;  
雨衣	雨衣	yǔ yī	raincoat; CL:件[jian4];  
预约	預約	yù yuē	booking; reservation; to book; to make an appointment;  
元素	元素	yuán sù	element; element of a set; chemical element;  
园	園	Yuán, yuán	surname Yuan;  land used for growing plants; site used for public recreation;  
园地	園地	yuán dì	garden area;  
原	原	Yuán, yuán	Hara (Japanese surname);  former; original; primary; raw; level; cause; source;  
原告	原告	yuán gào	complainant; plaintiff;  
原谅	原諒	yuán liàng	to excuse; to forgive; to pardon;  
圆珠笔	圓珠筆	yuán zhū bǐ	ballpoint pen; CL:支[zhi1],枝[zhi1];  
援助	援助	yuán zhù	to help; to support; to aid; aid; assistance;  
缘故	緣故	yuán gù	reason; cause;  
远方	遠方	yuǎn fāng	far away; a distant location;  
远离	遠離	yuǎn lí	to be far from; to keep away from;  
远远	遠遠	yuǎn yuǎn	distant;  
约定	約定	yuē dìng	to agree on sth (after discussion); to conclude a bargain; to arrange; to promise; to stipulate; to make an appointment; stipulated (time, amount, quality etc); an arrangement; a deal; appointment; undertaking; commitment; understanding; engagement; stipulation;  
乐曲	樂麯	yuè qǔ	musical composition;  
晕	暈	yūn, yùn	confused; dizzy; giddy; to faint; to swoon; to lose consciousness; to pass out;  dizzy; halo; ring around moon or sun;  
允许	允許	yǔn xǔ	to permit; to allow;  
运作	運作	yùn zuò	to operate; operations; workings; activities (usu. of an organization); thread (computing);  
晕车	暈車	yùn chē	to be carsick;  
杂	雜	zá, zá	mixed; miscellaneous; various; to mix;  
再生	再生	zài shēng	to be reborn; to regenerate; to be a second so-and-so (famous dead person); recycling; regeneration;  
再说	再說	zài shuō	to say again; to put off a discussion until later; moreover; what's more; besides;  
遭到	遭到	zāo dào	to suffer; to meet with (sth unfortunate);  
遭受	遭受	zāo shoù	to suffer; to sustain (loss, misfortune);  
遭遇	遭遇	zāo yù	to meet with; to encounter; (bitter) experience;  
早晚	早晚	zǎo wǎn	morning and evening; sooner or later;  
增进	增進	zēng jìn	to promote; to enhance; to further; to advance (a cause etc);  
增值	增值	zēng zhí	to appreciate (financially); to increase in value; value-added (accountancy);  
扎	紮	zhā, zhá, zā, zhā, zā	variant of 紮|扎[zha1];  penetrating (as of cold); struggle;  to tie; to bind; classifier for flowers, banknotes etc: bundle; Taiwan pr. [zha2];  
扎实	紮實	zhā shi, zhá shi	strong; solid; sturdy; firm; practical;  see 扎實|扎实[zha1 shi5];  
炸	炸	zhá, zhà	to deep fry;  to explode;  
炸弹	炸彈	zhà dàn	bomb; CL:枚[mei2],顆|颗[ke1];  
炸药	炸藥	zhà yào	explosive (material);  
债	債	zhài	debt; CL:筆|笔[bi3];  
占据	占據	zhàn jù	to occupy; to hold;  
战场	戰場	zhàn chǎng	battlefield; CL:個|个[ge4];  
战略	戰略	zhàn lüè	strategy;  
战术	戰術	zhàn shù	tactics;  
战友	戰友	zhàn yoǔ	comrade-in-arms; battle companion;  
站台	站颱	zhàn tái	platform (at a railway station);  
章	章	Zhāng, zhāng	surname Zhang;  chapter; section; clause; movement (of symphony); seal; badge; regulation; order;  
长	長	cháng, zhǎng	length; long; forever; always; constantly;  chief; head; elder; to grow; to develop; to increase; to enhance;  
掌声	掌聲	zhǎng shēng	applause; CL:陣|阵[zhen4];  
账	賬	zhàng	account; bill; debt; CL:本[ben3],筆|笔[bi3];  
账户	賬戶	zhàng hù	bank account; online account;  
涨	漲	zhǎng, zhàng	to rise (of prices, rivers);  to swell; to distend;  
障碍	障礙	zhàng ài	barrier; obstruction; hindrance; impediment; obstacle;  
招	招	zhāo	to recruit; to provoke; to beckon; to incur; to infect; contagious; a move (chess); a maneuver; device; trick; to confess;  
招聘	招聘	zhāo pìn	to invite applications for a job; to recruit;  
照样	照樣	zhào yàng	as before; (same) as usual; in the same manner; still; nevertheless;  
照耀	照耀	zhào yào	to shine; to illuminate;  
哲学	哲學	zhé xué	philosophy; CL:個|个[ge4];  
这就是说	這就是說	zhèjìushìshuō	This means that
镇	鎮	zhèn	to press down; to calm; to subdue; to suppress; to guard; garrison; small town; to cool or chill (food or drinks);  
争夺	爭奪	zhēng duó	to fight over; to contest; to vie over;  
整顿	整頓	zhěng dùn	to tidy up; to reorganize; to consolidate; to rectify;  
整治	整治	zhěng zhì	to bring under control; to regulate; to restore to good condition; (coll.) to fix (a person); to prepare (a meal etc);  
正当	正當	zhèng dāng, zhèng dàng	timely; just (when needed);  honest; reasonable; fair; sensible;  
政策	政策	zhèng cè	policy; CL:個|个[ge4];  
政党	政黨	zhèng dǎng	political party; CL:個|个[ge4];  
政权	政權	zhèng quán	regime; political power;  
症状	癥狀	zhèng zhuàng	symptom (of an illness);  
之类	之類	zhī lèi	and so on; and such;  
支撑	支撐	zhī chēng	to prop up; to support; strut; brace;  
支援	支援	zhī yuán	to provide assistance; to support; to back;  
枝	枝	zhī	branch; classifier for sticks, rods, pencils etc;  
知名	知名	zhī míng	well-known; famous;  
织	織	zhī	to weave; to knit;  
直升机	直升機	zhí shēng jī	helicopter; CL:架[jia4];  
职责	職責	zhí zé	duty; responsibility; obligation;  
止	止	zhǐ	to stop; to prohibit; until; only;  
只得	隻得	zhǐ dé	to have no alternative but to; to be obliged to;  
只顾	隻顧	zhǐ gù	solely preoccupied (with one thing); engrossed; focusing (on sth); to look after only one aspect;  
只管	隻管	zhǐ guǎn	solely engrossed in one thing; just (one thing, no need to worry about the rest); simply; by all means; please feel free; do not hesitate (to ask for sth);  
指定	指定	zhǐ dìng	to appoint; to assign; to indicate clearly and with certainty; designated;  
指数	指數	zhǐ shù	(numerical, statistical) index; (math.) exponent; index; exponential (function, growth);  
指头	指頭	zhǐ tou	finger; toe; CL:個|个[ge4];  
指着	指著	zhǐzháo	Poke
至于	至於	zhì yú	as for; as to; to go so far as to;  
治病	治病	zhì bìng	to treat an illness;  
智慧	智慧	zhì huì	wisdom; knowledge; intelligent; intelligence;  
中等	中等	zhōng děng	medium;  
中华	中華	Zhōng huá	China (alternate formal name);  
中期	中期	zhōng qī	middle (of a period of time); medium-term (plan, forecast etc);  
中外	中外	zhōng wài	Sino-foreign; Chinese-foreign; home and abroad;  
忠心	忠心	zhōng xīn	good faith; devotion; loyalty; dedication;  
钟头	鍾頭	zhōng toú	hour; CL:個|个[ge4];  
肿	腫	zhǒng	to swell; swelling; swollen;  
种种	種種	zhǒng zhǒng	all kinds of;  
粥	粥	yù, zhoū	see 葷粥|荤粥[Xun1 yu4];  congee; gruel; porridge; CL:碗[wan3];  
珠宝	珠寶	zhū bǎo	pearls; jewels; precious stones;  
诸位	諸位	zhū wèi	(pron) everyone; Ladies and Gentlemen; Sirs;  
主持人	主持人	zhǔ chí rén	TV or radio presenter; host; anchor;  
主角	主角	zhǔ jué	leading role; lead;  
主流	主流	zhǔ liú	main stream (of a river); fig. the essential point; main viewpoint of a matter; mainstream (culture etc);  
煮	煮	zhǔ, zhǔ	to cook; to boil;  
住宅	住宅	zhù zhái	residence; tenement;  
驻	駐	zhù	to halt; to stay; to be stationed (of troops, diplomats etc);  
柱子	柱子	zhù zi	pillar; CL:根[gen1];  
祝愿	祝願	zhù yuàn	to wish;  
专用	專用	zhuān yòng	special; dedicated;  
转	轉	zhuǎi, zhuǎn, zhuàn	see 轉文|转文[zhuai3 wen2];  to turn; to change direction; to transfer; to forward (mail);  to revolve; to turn; to circle about; to walk about; classifier for revolutions (per minute etc): revs, rpm; classifier for repeated actions;  
转动	轉動	zhuǎn dòng, zhuàn dòng	to turn sth around; to swivel;  to rotate (about an axis); to revolve; to turn; to move in a circle; to gyrate;  
赚	賺	zhuàn, zuàn	to earn; to make a profit;  to cheat; to swindle;  
赚钱	賺錢	zhuàn qián	to earn money; moneymaking;  
装备	裝備	zhuāng bèi	equipment; to equip; to outfit;  
壮观	壯觀	zhuàng guān	spectacular; magnificent sight;  
追究	追究	zhuī jiū	to investigate; to look into;  
捉	捉	zhuō	to clutch; to grab; to capture;  
咨询	谘詢	zī xún	to consult; to seek advice; consultation; (sales) inquiry (formal);  
自来水	自來水	zì lái shuǐ	running water; tap water;  
自我	自我	zì wǒ	self-; ego (psychology);  
自学	自學	zì xué	self-study; to study on one's own;  
自言自语	自言自語	zì yán zì yǔ	to talk to oneself; to think aloud; to soliloquize;  
自在	自在	zì zai	free; unrestrained; comfortable; at ease;  
宗教	宗教	zōng jiào	religion;  
总部	總部	zǒng bù	general headquarters;  
总监	總監	zǒng jiān	head; director (of an organizational unit); (police) commissioner; inspector-general; rank of local governor in Tang dynasty administration;  
总经理	總經理	zǒng jīng lǐ	general manager; CEO;  
总量	總量	zǒng liàng	total; overall amount;  
走私	走私	zoǔ sī	to smuggle; to have an illicit affair;  
奏	奏	zoù	to play music; to achieve; to present a memorial to the emperor (old);  
租金	租金	zū jīn	rent;  
足	足	jù, zú	excessive;  foot; to be sufficient; ample;  
足以	足以	zú yǐ	sufficient to...; so much so that; so that;  
族	族	zú	race; nationality; ethnicity; clan; by extension, social group (e.g. office workers 上班族);  
族	族	zú	race; nationality; ethnicity; clan; by extension, social group (e.g. office workers 上班族);  
祖父	祖父	zǔ fù	father's father; paternal grandfather;  
祖国	祖國	zǔ guó	motherland;  
祖母	祖母	zǔ mǔ	father's mother; paternal grandmother;  
钻	鑽	zuàn, zuān, zuàn	an auger; diamond;  to drill; to bore; to get into; to make one's way into; to enter (a hole); to thread one's way through; to study intensively; to dig into; to curry favor for personal gain;  
最佳	最佳	zuì jiā	optimum; optimal; peak; best (athlete, movie etc);  
最终	最終	zuì zhōng	final; ultimate;  
罪	罪	zuì, zuì	variant of 罪[zui4], crime;  
罪恶	罪惡	zuì è	crime; evil; sin;  
作	作	zuō, zuò	worker; workshop; (slang) troublesome; high-maintenance (person);  to do; to grow; to write or compose; to pretend; to regard as; to feel; writings or works;  
作废	作廢	zuò fèi	to become invalid; to cancel; to delete; to nullify;  
作战	作戰	zuò zhàn	combat; to fight;  
座谈会	座談會	zuò tán huì	conference; symposium; rap session;  
