安慰	安慰	ān wèi	to comfort; to console; CL:個|个[ge4];  
岸	岸	àn, àn	bank; shore; beach; coast; CL:個|个[ge4];  
岸上	岸上	àn shàng	ashore; on the riverbank;  
按摩	按摩	àn mó	massage; to massage;  
拔	拔	bá	to pull up; to pull out; to draw out by suction; to select; to pick; to stand out (above level); to surpass; to seize;  
白酒	白酒	bái jiǔ	spirit usually distilled from sorghum or maize; white spirit;  
拜访	拜訪	bài fǎng	to pay a visit; to call on;  
版	版	bǎn	a register; block of printing; edition; version; page;  
扮演	扮演	bàn yǎn	to play the role of; to act;  
棒	棒	bàng	stick; club; cudgel; smart; capable; strong; wonderful; classifier for legs of a relay race;  
包围	包圍	bāo wéi	to surround; to encircle; to hem in;  
包装	包裝	bāo zhuāng	to pack; to package; to wrap; packaging;  
保卫	保衛	bǎo wèi	to defend; to safeguard;  
保养	保養	bǎo yǎng	to take good care of (or conserve) one's health; to keep in good repair; to maintain; maintenance;  
报答	報答	bào dá	to repay; to requite;  
报警	報警	bào jǐng	to sound an alarm; to report sth to the police;  
抱怨	抱怨	bào yuàn	to complain; to grumble; to harbor a complaint; to feel dissatisfied;  
背包	背包	bēi bāo	knapsack; rucksack; infantry pack; field pack; blanket roll; CL:個|个[ge4];  
悲剧	悲劇	bēi jù	tragedy; CL:出[chu1];  
悲伤	悲傷	bēi shāng	sad; sorrowful;  
北极	北極	běi jí	the North Pole; the Arctic Pole; the north magnetic pole;  
被动	被動	bèi dòng	passive;  
辈	輩	bèi	lifetime; generation; group of people; class; classifier for generations; (literary) classifier for people;  
本人	本人	běn rén	the person himself; I (humble form used in speeches); oneself; myself; in person; personal;  
鼻子	鼻子	bí zi	nose; CL:個|个[ge4],隻|只[zhi1];  
比方	比方	bǐ fang	analogy; instance; for instance;  
比重	比重	bǐ zhòng	proportion; specific gravity;  
彼此	彼此	bǐ cǐ	each other; one another;  
必	必	bì	certainly; must; will; necessarily;  
必需	必需	bì xū	to need; to require; essential; indispensable;  
毕竟	畢竟	bì jìng	after all; all in all; when all is said and done; in the final analysis;  
闭幕	閉幕	bì mù	the curtain falls; lower the curtain; to come to an end (of a meeting);  
闭幕式	閉幕式	bì mù shì	closing ceremony;  
边境	邊境	biān jìng	frontier; border;  
编辑	編輯	biān jí	to edit; to compile; editor; compiler;  
编辑	編輯	biān jí	to edit; to compile; editor; compiler;  
变动	變動	biàn dòng	to change; to fluctuate; change; fluctuation;  
便利	便利	biàn lì	convenient; easy; to facilitate;  
便条	便條	biàn tiáo	(informal) note; CL:張|张[zhang1],個|个[ge4];  
便于	便於	biàn yú	easy to; convenient for;  
宾馆	賓館	bīn guǎn	guesthouse; lodge; hotel; CL:個|个[ge4],家[jia1];  
饼	餅	bǐng	round flat cake; cookie; cake; pastry; CL:張|张[zhang1];  
饼干	餅乾	bǐng gān	biscuit; cracker; cookie; CL:片[pian4],塊|块[kuai4];  
病毒	病毒	bìng dú	virus;  
玻璃	玻璃	bō li	glass; CL:張|张[zhang1],塊|块[kuai4]; (slang) male homosexual;  
博客	博客	bó kè	blog (loanword); weblog; blogger;  
博览会	博覽會	bó lǎn huì	exposition; international fair;  
博士	博士	bó shì	doctor; court academician (in feudal China); Ph.D.;  
博物馆	博物館	bó wù guǎn	museum;  
薄弱	薄弱	bó ruò	weak; frail;  
不顾	不顧	bù gù	in spite of; regardless of;  
不利	不利	bù lì	unfavorable; disadvantageous; harmful; detrimental;  
不耐烦	不耐煩	bù nài fán	impatience; impatient;  
不幸	不幸	bù xìng	misfortune; adversity; unfortunate; sad; unfortunately; CL:個|个[ge4];  
不易	不易	bù yì	not easy to do sth; difficult; unchanging;  
补偿	補償	bǔ cháng	to compensate; to make up;  
补贴	補貼	bǔ tiē	to subsidize; subsidy; allowance; to supplement (one's salary etc); benefit;  
不曾	不曾	bù céng	hasn't yet; hasn't ever;  
不得了	不得瞭	bù dé liǎo	desperately serious; disastrous; extremely; exceedingly;  
不敢当	不敢當	bù gǎn dāng	lit. I dare not (accept the honor); fig. I don't deserve your praise; you flatter me;  
不良	不良	bù liáng	bad; harmful; unhealthy;  
不免	不免	bù miǎn	inevitably;  
不能不	不能不	bù néng bù	have to; cannot but;  
不时	不時	bù shí	from time to time; now and then; occasionally; frequently;  
不停	不停	bù tíng	incessant;  
不许	不許	bù xǔ	not to allow; must not; can't;  
不止	不止	bù zhǐ	incessantly; without end; more than; not limited to;  
不足	不足	bù zú	insufficient; lacking; deficiency; not enough; inadequate; not worth; cannot; should not;  
部位	部位	bù wèi	position; place;  
猜	猜	cāi	to guess;  
猜测	猜測	cāi cè	to guess; to conjecture; to surmise;  
裁判	裁判	cái pàn	judgment; to referee; umpire; judge; referee; CL:個|个[ge4],位[wei4],名[ming2];  
采购	采購	cǎi goù	to procure (for an enterprise etc); to purchase;  
彩票	彩票	cǎi piào	lottery ticket;  
餐馆	餐館	cān guǎn	restaurant; CL:家[jia1];  
餐厅	餐廳	cān tīng	dining hall; dining room; restaurant; CL:間|间[jian1],家[jia1];  
餐饮	餐飲	cān yǐn	food and beverage; catering; repast;  
草原	草原	cǎo yuán	grassland; prairie; CL:片[pian4];  
册	冊	cè	book; booklet; classifier for books;  
层次	層次	céng cì	layer; level; gradation; arrangement of ideas; (a person's) standing;  
叉	叉	chā, chá, chǎ	fork; pitchfork; prong; pick; cross; intersect; 'X';  to cross; be stuck;  to diverge; to open (as legs);  
叉子	叉子	chā zi	fork; CL:把[ba3];  
差别	差彆	chā bié	difference; distinction; disparity;  
差距	差距	chā jù	disparity; gap;  
插	插	chā, chā	old variant of 插[cha1];  
查询	查詢	chá xún	to check; to inquire; to consult (a document etc); inquiry; query;  
差点儿	差點兒	cha4 dian3 r5	erhua variant of 差點|差点[cha4 dian3];  
拆	拆	chāi	to tear open; to tear down; to tear apart; to open;  
拆除	拆除	chāi chú	to tear down; to demolish; to dismantle; to remove;  
产业	産業	chǎn yè	industry; estate; property; industrial;  
长度	長度	cháng dù	length;  
长寿	長壽	Cháng shoù, cháng shoù	Changshou suburban district of Chongqing municipality, formerly in Sichuan;  longevity; ability to live long; long lived;  
肠	腸	cháng, cháng	old variant of 腸|肠[chang2];  
尝	嘗	cháng, cháng, cháng	old variant of 嘗|尝[chang2];  
尝试	嘗試	cháng shì	to try; to attempt; CL:次[ci4];  
厂长	廠長	chǎng zhǎng	factory director;  
场面	場麵	chǎng miàn	scene; spectacle; occasion; situation;  
倡导	倡導	chàng dǎo	to advocate; to initiate; to propose; to be a proponent of (an idea or school of thought);  
超越	超越	chāo yuè	to surpass; to exceed; to transcend;  
车主	車主	chē zhǔ	vehicle owner;  
称	稱	chèn, chēng, chèng	to fit; balanced; suitable;  to weigh; to state; to name; name; appellation; to praise;  variant of 秤[cheng4]; steelyard;  
称号	稱號	chēng hào	name; term of address; title;  
成本	成本	chéng běn	(manufacturing, production etc) costs;  
成交	成交	chéng jiāo	to complete a contract; to reach a deal;  
成效	成效	chéng xiào	effect; result;  
成语	成語	chéng yǔ	Chinese set expression, typically of 4 characters, often alluding to a story or historical quotation; idiom; proverb; saying; adage; CL:條|条[tiao2],本[ben3],句[ju4];  
承办	承辦	chéng bàn	to undertake; to accept a contract;  
城里	城裏	chénglǐ	In the city
乘	乘	Chéng, chéng, shèng, chéng	surname Cheng;  old variant of 乘[cheng2];  four horse military chariot (archaic); four (archaic); generic term for history books;  
乘车	乘車	chéng chē	to ride (in a car or carriage); to drive; to motor;  
乘客	乘客	chéng kè	passenger;  
乘坐	乘坐	chéng zuò	to ride (in a vehicle);  
吃力	吃力	chī lì	to entail strenuous effort; to toil at a task; strenuous; laborious; strain;  
池子	池子	chí zi	pond; bathhouse pool; dance floor of a ballroom; (old) stalls (front rows in a theater);  
迟	遲	Chí, chí	surname Chi;  late; delayed; slow;  
冲动	衝動	chōng dòng	to have an urge; to be impetuous; impulse; urge;  
冲突	衝突	chōng tū	conflict; to conflict; clash of opposing forces; collision (of interests); contention;  
充足	充足	chōng zú	adequate; sufficient; abundant;  
愁	愁	choú	to worry about;  
丑	醜	Choǔ, choǔ, choǔ	surname Chou;  shameful; ugly; disgraceful;  
臭	臭	choù, xiù	stench; smelly; to smell (bad); repulsive; loathsome; terrible; bad; severely; ruthlessly; dud (ammunition);  sense of smell; smell bad;  
出版	齣版	chū bǎn	to publish;  
出差	齣差	chū chāi	to go on an official or business trip;  
出汗	齣汗	chū hàn	to perspire; to sweat;  
出于	齣於	chū yú	due to; to stem from;  
初期	初期	chū qī	initial stage; beginning period;  
除非	除非	chú fēi	only if (..., or otherwise, ...); only when; only in the case that; unless;  
除夕	除夕	Chú xī	lunar New Year's Eve;  
厨房	廚房	chú fáng	kitchen; CL:間|间[jian1];  
处罚	處罰	chǔ fá	to penalize; to punish;  
处分	處分	chǔ fèn	to discipline sb; to punish; disciplinary action; to deal with (a matter); CL:個|个[ge4];  
处在	處在	chǔ zài	to be situated at; to find oneself at;  
传达	傳達	chuán dá	to pass on; to convey; to relay; to transmit; transmission;  
传递	傳遞	chuán dì	to transmit; to pass on to sb else; (math.) transitive;  
传真	傳真	chuán zhēn	fax; facsimile;  
窗帘	窗簾	chuāng lián	window curtains;  
闯	闖	chuǎng	to rush; to charge; to dash; to break through; to temper oneself (through battling hardships);  
创立	創立	chuàng lì	to establish; to set up; to found;  
辞典	辭典	cí diǎn	dictionary (of Chinese compound words); also written 詞典|词典[ci2 dian3]; CL:本[ben3],部[bu4];  
辞职	辭職	cí zhí	to resign;  
此后	此後	cǐ hoù	after this; afterwards; hereafter;  
此刻	此刻	cǐ kè	this moment; now; at present;  
此时	此時	cǐ shí	now; this moment;  
聪明	聰明	cōng ming	intelligent; clever; bright; smart; acute (of sight and hearing);  
从而	從而	cóng ér	thus; thereby;  
从中	從中	cóng zhōng	from within; therefrom;  
脆	脆	cuì, cuì	brittle; fragile; crisp; crunchy; clear and loud voice; neat;  
存款	存款	cún kuǎn	to deposit money (in a bank etc); bank savings; bank deposit;  
寸	寸	cùn	a unit of length; inch; thumb;  
达成	達成	dá chéng	to reach (an agreement); to accomplish;  
答	答	dā, dá	to answer; to agree;  reply; answer; return; respond; echo;  
答复	答復	dá fù, dá fù	to answer; to reply; Reply to: (in email header);  
打	打	dá, dǎ	dozen (loanword);  to beat; to strike; to hit; to break; to type; to mix up; to build; to fight; to fetch; to make; to tie up; to issue; to shoot; to calculate; to play (a game); since; from;  
打扮	打扮	dǎ ban	to decorate; to dress; to make up; to adorn; manner of dressing; style of dress;  
打包	打包	dǎ bāo	to wrap; to pack; to put leftovers in a doggy bag for take-out;  
打击	打擊	dǎ jī	to hit; to strike; to attack; to crack down on sth; blow; (psychological) shock; percussion (music);  
打架	打架	dǎ jià	to fight; to scuffle; to come to blows; CL:場|场[chang2];  
打扰	打擾	dǎ rǎo	to disturb; to bother; to trouble;  
大胆	大膽	dà dǎn	brazen; audacious; outrageous; bold; daring; fearless;  
大都	大都	Dà dū, dà doū, dà dū	Dadu, capital of China during the Yuan Dynasty (1280-1368), modern day Beijing;  for the most part; on the whole; also pr. [da4 du1];  for the most part; on the whole; metropolitan;  
大纲	大綱	dà gāng	synopsis; outline; program; leading principles;  
大伙儿	大夥兒	da4 huo3 r5	erhua variant of 大伙[da4 huo3];  
大奖赛	大奬賽	dàjiǎngsài	Grand prize
大脑	大腦	dà nǎo	brain; cerebrum;  
大事	大事	dà shì	major event; major political event (war or change of regime); major social event (wedding or funeral); (do sth) in a big way; CL:件[jian4],樁|桩[zhuang1];  
大厅	大廳	dà tīng	hall; lounge;  
大象	大象	dà xiàng	elephant; CL:隻|只[zhi1];  
大熊猫	大熊貓	dà xióng māo	giant panda (Ailuropoda melanoleuca);  
大于	大於	dà yú	greater than; bigger than; more than, >;  
大致	大緻	dà zhì	more or less; roughly; approximately;  
呆	呆	dāi	foolish; stupid; expressionless; blank; to stay;  
待	待	dāi, dài	to stay;  to wait; to treat; to deal with; to need; going to (do sth); about to; intending to;  
代价	代價	dài jià	price; cost; consideration (in share dealing);  
代理	代理	dài lǐ	to act on behalf of sb in a responsible position; to act as an agent or proxy; surrogate;  
带有	帶有	dài yoǔ	to have; to involve;  
贷款	貸款	dài kuǎn	a loan; CL:筆|笔[bi3]; to provide a loan (e.g. bank); to raise a loan (from e.g. a bank);  
单一	單一	dān yī	single; only; sole;  
胆	膽	dǎn	gall bladder; courage; guts; gall; inner container (e.g. bladder of a football, inner container of a thermos);  
胆小	膽小	dǎn xiǎo	cowardice; timid;  
蛋糕	蛋糕	dàn gāo	cake; CL:塊|块[kuai4],個|个[ge4];  
当场	當場	dāng chǎng	at the scene; on the spot;  
当代	當代	dāng dài	the present age; the contemporary era;  
当年	當年	dāng nián, dàng nián	in those days; then; in those years; during that time;  that very same year;  
当前	當前	dāng qián	current; today's; modern; present; to be facing (us);  
当选	當選	dāng xuǎn	to be elected;  
挡	擋	dǎng, dàng, dǎng	variant of 擋|挡[dang3];  to arrange; to put in order;  
到来	到來	dào lái	to arrive; arrival; advent;  
倒是	倒是	dào shi	contrary to what one might expect; actually; contrariwise; why don't you;  
道德	道德	dào dé	virtue; morality; ethics; CL:種|种[zhong3];  
得了	得瞭	dé le, dé liǎo	all right!; that's enough!;  (emphatically, in rhetorical questions) possible;  
得以	得以	dé yǐ	able to; so that sb can; enabling; in order to; finally in a position to; with sth in view;  
等候	等候	děng hoù	to wait; to wait for;  
等级	等級	děng jí	grade; rank; status;  
低于	低於	dī yú	to be lower than;  
地带	地帶	dì dài	zone; CL:個|个[ge4];  
地形	地形	dì xíng	topography; terrain; landform;  
地震	地震	dì zhèn	earthquake;  
递	遞	dì	to hand over; to pass on sth; to gradually increase or decrease; progressively;  
递给	遞給	dìgěi	Handle
典礼	典禮	diǎn lǐ	celebration; ceremony;  
点燃	點燃	diǎn rán	to ignite; to set on fire; aflame;  
电池	電池	diàn chí	battery; CL:節|节[jie2],組|组[zu3];  
电饭锅	電飯鍋	diàn fàn guō	electric rice cooker;  
电子版	電子版	diànzǐbǎn	e-edition
调动	調動	diào dòng	to transfer; to maneuver (troops etc); movement of personnel; to mobilize; to bring into play;  
丢	丟	diū	to lose; to put aside; to throw;  
动机	動機	dòng jī	motor; locomotive; motive; motivation; intention;  
动手	動手	dòng shoǔ	to set about (a task); to hit; to punch; to touch;  
动态	動態	dòng tài	movement; motion; development; trend; dynamic (science);  
动员	動員	dòng yuán	to mobilize; to arouse; mobilization; CL:次[ci4],個|个[ge4];  
冻	凍	dòng	to freeze; to feel very cold; aspic or jelly;  
洞	洞	dòng	cave; hole; zero (unambiguous spoken form when spelling out numbers); CL:個|个[ge4];  
豆制品	豆製品	dòuzhìpǐn	Bean products
毒	毒	dú	poison; to poison; poisonous; malicious; cruel; fierce; narcotics;  
堆	堆	duī	to pile up; to heap up; a mass; pile; heap; stack; large amount;  
对立	對立	duì lì	to oppose; to set sth against; to be antagonistic to; antithetical; relative opposite; opposing; diametrical;  
对应	對應	duì yìng	to correspond; a correspondence; corresponding; homologous; matching with sth; counterpart;  
吨	噸	dūn	ton (loanword); Taiwan pr. [dun4];  
朵	朵	duǒ, duǒ	variant of 朵[duo3];  
躲	躲	duǒ	to hide; to dodge; to avoid;  
儿女	兒女	ér nǚ	children; sons and daughters;  
耳朵	耳朵	ěr duo	ear; CL:隻|只[zhi1],個|个[ge4],對|对[dui4]; handle (on a cup);  
二维码	二維碼	èr wéi mǎ	two-dimensional barcode; QR code;  
发布	發布	fā bù, fā bù	to release; to issue; to announce; to distribute;  
发觉	發覺	fā jué	to become aware; to detect; to realize; to perceive;  
发射	發射	fā shè	to shoot (a projectile); to fire (a rocket); to launch; to emit (a particle); to discharge; emanation; emission;  
发行	發行	fā xíng	to publish; to issue (stocks, currency etc); to release; to distribute (a film);  
罚	罰	fá, fá	variant of 罰|罚[fa2];  
罚款	罰款	fá kuǎn	to fine; penalty; fine (monetary);  
法规	法規	fǎ guī	legislation; statute;  
法制	法製	fǎ zhì, Fǎ zhì	legal system and institutions;  made in France;  
繁荣	繁榮	fán róng	prosperous; booming (economy);  
返回	返迴	fǎn huí	to return to; to come (or go) back;  
防治	防治	fáng zhì	prevention and cure;  
放大	放大	fàng dà	to enlarge; to magnify;  
放弃	放棄	fàng qì	to renounce; to abandon; to give up;  
分成	分成	fēn chéng	to divide (into); to split a bonus; to break into; tenths; percentage allotment;  
分解	分解	fēn jiě	to resolve; to decompose; to break down;  
分类	分類	fēn lèi	classification;  
分离	分離	fēn lí	to separate;  
分析	分析	fēn xī	to analyze; analysis; CL:個|个[ge4];  
分享	分享	fēn xiǎng	to share (let others have some of sth good);  
丰收	豐收	fēng shoū	bumper harvest;  
风度	風度	fēng dù	elegance (for men); elegant demeanor; grace; poise;  
风光	風光	fēng guāng	scene; view; sight; landscape; to be well-regarded; to be well-off; grand (dialect); impressive (dialect);  
封	封	Fēng, fēng	surname Feng;  to confer; to grant; to bestow a title; to seal; classifier for sealed objects, esp. letters;  
疯	瘋	fēng	insane; mad; wild;  
疯狂	瘋狂	fēng kuáng	crazy; frantic; extreme popularity;  
扶	扶	fú	to support with the hand; to help sb up; to support oneself by holding onto something; to help;  
服从	服從	fú cóng	to obey (an order); to comply; to defer;  
幅	幅	fú	width; roll; classifier for textiles or pictures;  
幅度	幅度	fú dù	width; extent; range; scope;  
福利	福利	fú lì	material benefit; benefit in kind; (social) welfare;  
辅助	輔助	fǔ zhù	to assist; to aid; supplementary; auxiliary; subsidiary;  
负责人	負責人	fù zé rén	person in charge;  
附件	附件	fù jiàn	enclosure; attachment (email); appendix;  
改革	改革	gǎi gé	reform; CL:次[ci4],種|种[zhong3],項|项[xiang4]; to reform;  
干脆	乾脆	gān cuì	straightforward; clear-cut; blunt (e.g. statement); you might as well; simply;  
干扰	乾擾	gān rǎo	to disturb; to interfere; perturbation; interference (physics);  
干预	乾預	gān yù	to meddle; to intervene; intervention;  
感想	感想	gǎn xiǎng	impressions; reflections; thoughts; CL:通[tong4],個|个[ge4];  
钢笔	鋼筆	gāng bǐ	fountain pen; CL:支[zhi1];  
钢琴	鋼琴	gāng qín	piano; CL:架[jia4],臺|台[tai2];  
高大	高大	gāo dà	tall; lofty;  
高度	高度	gāo dù	height; altitude; elevation; high degree; highly; CL:個|个[ge4];  
高跟鞋	高跟鞋	gāo gēn xié	high-heeled shoes;  
高温	高溫	gāo wēn	high temperature;  
高于	高於	gāo yú	greater than; to exceed;  
高原	高原	gāo yuán	plateau; CL:片[pian4];  
搞	搞	gǎo	to do; to make; to go in for; to set up; to get hold of; to take care of;  
搞好	搞好	gǎo hǎo	to do well at; to do a good job;  
歌曲	歌麯	gē qǔ	song;  
隔壁	隔壁	gé bì	next door; neighbor;  
个儿	個兒	ge4 r5	size; height; stature;  
跟前	跟前	gēn qián, gēn qian	the front (of); (in) front; (in) sb's presence; just before (a date);  (of children, parents etc) at one's side; living with one;  
跟随	跟隨	gēn suí	to follow;  
更换	更換	gēng huàn	to replace (a worn-out tire etc); to change (one's address etc);  
更新	更新	gēng xīn	to replace the old with new; to renew; to renovate; to upgrade; to update; to regenerate;  
工艺	工藝	gōng yì	arts and crafts; industrial arts;  
工作日	工作日	gōng zuò rì	workday; working day; weekday;  
公告	公告	gōng gào	post; announcement;  
公认	公認	gōng rèn	publicly known (to be); accepted (as);  
公式	公式	gōng shì	formula;  
公正	公正	gōng zhèng	just; fair; equitable;  
共计	共計	gòng jì	to sum up to; to total;  
共享	共享	gòng xiǎng	to share; to enjoy together;  
沟	溝	goū	ditch; gutter; groove; gully; ravine; CL:道[dao4];  
沟通	溝通	goū tōng	to join; to connect; to link up; to communicate;  
估计	估計	gū jì	to estimate; to reckon; CL:個|个[ge4]; (coll.) to suppose;  
古老	古老	gǔ lǎo	ancient; old; age-old;  
鼓	鼓	gǔ, gǔ	drum; CL:通[tong4],面[mian4]; to drum; to strike; to rouse; to bulge; to swell;  
鼓励	鼓勵	gǔ lì	to encourage;  
鼓掌	鼓掌	gǔ zhǎng	to applaud; to clap;  
顾问	顧問	gù wèn	adviser; consultant;  
怪	怪	guài, guài	variant of 怪[guai4];  
关怀	關懷	guān huái	care; solicitude; to show care for; concerned about; attentive to;  
关键	關鍵	guān jiàn	crucial point; crux; CL:個|个[ge4]; key; crucial; pivotal;  
冠军	冠軍	guàn jūn	champion; CL:個|个[ge4];  
光荣	光榮	guāng róng	honor and glory; glorious;  
光线	光綫	guāng xiàn	light ray; CL:條|条[tiao2],道[dao4]; light; illumination; lighting (for a photograph);  
广	廣	Guǎng, guǎng	surname Guang;  wide; numerous; to spread;  
广泛	廣泛	guǎng fàn	extensive; wide range;  
规划	規劃	guī huà	to plan (how to do sth); planning; plan; program;  
鬼	鬼	guǐ	ghost; demon; terrible; damnable; clever; sly; crafty; sinister plot; (suffix for sb with a certain vice or addiction etc); one of the 28 constellations;  
柜子	櫃子	guì zi	cupboard; cabinet;  
滚	滾	gǔn	to boil; to roll; to take a hike; Get lost!;  
锅	鍋	guō	pot; pan; boiler; CL:口[kou3],隻|只[zhi1];  
国籍	國籍	guó jí	nationality;  
国民	國民	guó mín	nationals; citizens; people of a nation;  
过度	過度	guò dù	excessive; over-; excess; going too far; extravagant; intemperate; overdue;  
过敏	過敏	guò mǐn	oversensitive; allergic; allergy;  
过于	過於	guò yú	too much; excessively;  
害	害	hài	to do harm to; to cause trouble to; harm; evil; calamity;  
汗	汗	hán, hàn	see 可汗[ke4 han2], 汗國|汗国[han2 guo2];  perspiration; sweat; CL:滴[di1],頭|头[tou2],身[shen1]; to be speechless (out of helplessness, embarrassment etc) (Internet slang used as an interjection);  
好运	好運	hǎo yùn	good luck;  
号召	號召	hào zhào	to call; to appeal;  
合并	閤並	hé bìng, hé bìng	to merge; to annex;  
合成	閤成	hé chéng	to compose; to constitute; compound; synthesis; mixture; synthetic;  
盒	盒	hé	small box; case;  
盒饭	盒飯	hé fàn	meal in a partitioned box;  
盒子	盒子	hé zi	box; case;  
贺卡	賀卡	hè kǎ	greeting card; congratulation card;  
恨	恨	hèn	to hate; to regret;  
猴	猴	hoú	monkey; CL:隻|只[zhi1];  
后悔	後悔	hoù huǐ	to regret; to repent;  
胡同儿	鬍同兒	hútóngér	Alley
胡子	鬍子	hú zi	beard; mustache or whiskers; facial hair; CL:撮[zuo3],根[gen1]; (coll.) bandit;  
虎	虎	hǔ	tiger; CL:隻|只[zhi1];  
华语	華語	Huá yǔ	Chinese language;  
滑	滑	Huá, huá	surname Hua;  to slip; to slide; smooth; slippery; cunning;  
化石	化石	huà shí	fossil;  
划分	劃分	huà fēn	to divide up; to partition; to differentiate;  
画面	畫麵	huà miàn	scene; tableau; picture; image; screen (displayed by a computer); (motion picture) frame; field of view;  
环节	環節	huán jié	round segment; segment (of annelid worms); connection; link; sector; annular ring;  
慌	慌	huāng	to get panicky; to lose one's head; (coll.) (after 得) unbearably; terribly;  
慌忙	慌忙	huāng máng	in a great rush; in a flurry;  
灰色	灰色	huī sè	gray; ash gray; grizzly; pessimistic; gloomy; dispirited; ambiguous;  
恢复	恢復	huī fù	to reinstate; to resume; to restore; to recover; to regain; to rehabilitate;  
回报	迴報	huí bào	(in) return; reciprocation; payback; retaliation; to report back; to reciprocate;  
回避	迴避	huí bì, huí bì	to shun; to avoid (sb); to skirt; to evade (an issue); to step back; to withdraw; to recuse (a judge etc);  
回顾	迴顧	huí gù	to look back; to review;  
回收	迴收	huí shoū	to recycle; to reclaim; to retrieve; to recover; to recall (a defective product);  
回头	迴頭	huí toú	to turn round; to turn one's head; later; by and by;  
回信	迴信	huí xìn	to reply; to write back; letter written in reply; CL:封[feng1];  
回忆	迴憶	huí yì	to recall; memories; CL:個|个[ge4];  
汇款	匯款	huì kuǎn	to remit money; remittance;  
会谈	會談	huì tán	talks; discussions; CL:次[ci4];  
活力	活力	huó lì	energy; vitality; vigor; vital force;  
活泼	活潑	huó po	lively; vivacious; brisk; active;  
火柴	火柴	huǒ chái	match (for lighting fire); CL:根[gen1],盒[he2];  
火腿	火腿	huǒ tuǐ	ham; CL:個|个[ge4];  
火灾	火災	huǒ zāi	fire (that burns buildings etc);  
或是	或是	huò shì	or; either one or the other;  
机器人	機器人	jī qì rén	mechanical person; robot; android;  
机制	機製	jī zhì, jī zhì	machine processed; machine made; mechanism;  
肌肉	肌肉	jī roù	muscle; flesh;  
基地	基地	jī dì	base (of operations); industrial or military base; al-Qaeda;  
基金	基金	jī jīn	fund;  
即使	即使	jí shǐ	even if; even though;  
集团	集團	jí tuán	group; bloc; corporation; conglomerate;  
挤	擠	jǐ	to crowd in; to cram in; to force others aside; to press; to squeeze; to find (time in one's busy schedule);  
记忆	記憶	jì yì	to remember; to recall; memory; CL:個|个[ge4];  
技能	技能	jì néng	technical ability; skill;  
继承	繼承	jì chéng	to inherit; to succeed to (the throne etc); to carry on (a tradition etc);  
加热	加熱	jiā rè	to heat;  
加上	加上	jiā shàng	plus; to put in; to add; to add on; to add into; in addition; on top of that;  
加速	加速	jiā sù	to speed up; to expedite;  
加以	加以	jiā yǐ	in addition; moreover; (used before a disyllabic verb to indicate that the action of the verb is applied to sth or sb previously mentioned); to apply (restrictions etc) to (sb); to give (support, consideration etc) to (sth);  
夹	夾	jiā, jiá, jià, jiá	to press from either side; to place in between; to sandwich; to carry sth under armpit; wedged between; between; to intersperse; to mix; to mingle; clip; folder; Taiwan pr. [jia2];  variant of 夾|夹[jia2];  Taiwan pr. used in 夾生|夹生[jia1 sheng1] and 夾竹桃|夹竹桃[jia1 zhu2 tao2];  
甲	甲	jiǎ	first of the ten Heavenly Stems 十天干[shi2 tian1 gan1]; (used for an unspecified person or thing); first (in a list, as a party to a contract etc); letter 'A' or roman 'I' in list 'A, B, C', or 'I, II, III' etc; armor plating; shell or carapace; (of the fingers or toes) nail; bladed leather or metal armor (old); ranking system used in the Imperial examinations (old); civil administration unit (old); ancient Chinese compass point: 75°;  
价	價	jià, jie	price; value; (chemistry) valence;  great; good; middleman; servant;  
驾驶	駕駛	jià shǐ	to pilot (ship, airplane etc); to drive;  
驾照	駕照	jià zhào	driver's license;  
坚定	堅定	jiān dìng	firm; steady; staunch; resolute;  
肩	肩	jiān	shoulder; to shoulder (responsibilities etc);  
艰苦	艱苦	jiān kǔ	difficult; hard; arduous;  
艰难	艱難	jiān nán	difficult; hard; challenging;  
检验	檢驗	jiǎn yàn	to inspect; to examine; to test;  
减轻	減輕	jiǎn qīng	to lighten; to ease; to alleviate;  
剪	剪	Jiǎn, jiǎn	surname Jian;  scissors; shears; clippers; CL:把[ba3]; to cut with scissors; to trim; to wipe out or exterminate;  
剪刀	剪刀	jiǎn dāo	scissors; CL:把[ba3];  
剪子	剪子	jiǎn zi	clippers; scissors; shears; CL:把[ba3];  
间接	間接	jiàn jiē	indirect;  
建造	建造	jiàn zào	to construct; to build;  
建筑	建築	jiàn zhù	to construct; building; CL:個|个[ge4];  
健全	健全	jiàn quán	robust; sound;  
键	鍵	jiàn	key (on a piano or computer keyboard); button (on a mouse or other device); chemical bond; linchpin;  
键盘	鍵盤	jiàn pán	keyboard;  
将	將	jiāng, jiàng, qiāng	will; shall; to use; to take; to checkmate; just a short while ago; (introduces object of main verb, used in the same way as 把[ba3]);  general; commander-in-chief (military); king (chess piece); to command; to lead;  to desire; to invite; to request;  
将要	將要	jiāng yào	will; shall; to be going to;  
奖励	奬勵	jiǎng lì	to reward; reward (as encouragement);  
交代	交代	jiāo dài	to hand over; to explain; to make clear; to brief (sb); to account for; to justify oneself; to confess; to finish (colloquial);  
郊区	郊區	jiāo qū	suburban district; outskirts; suburbs; CL:個|个[ge4];  
胶带	膠帶	jiāo dài	adhesive tape; rubber belt; recording tape;  
胶水	膠水	jiāo shuǐ	glue;  
脚步	腳步	jiǎo bù	footstep; step;  
接触	接觸	jiē chù	to touch; to contact; access; in touch with;  
接连	接連	jiē lián	on end; in a row; in succession;  
解除	解除	jiě chú	to remove; to sack; to get rid of; to relieve (sb of their duties); to free; to lift (an embargo); to rescind (an agreement);  
解放	解放	jiě fàng	to liberate; to emancipate; liberation; refers to the Communists' victory over the Nationalists in 1949; CL:次[ci4];  
戒	戒	jiè	to guard against; to exhort; to admonish or warn; to give up or stop doing sth; Buddhist monastic discipline; ring (for a finger);  
届	屆	jiè	to arrive at (place or time); period; to become due; classifier for events, meetings, elections, sporting fixtures, years (of graduation);  
今日	今日	jīn rì	today;  
尽管	盡管	jǐn guǎn	despite; although; even though; in spite of; unhesitatingly; do not hesitate (to ask, complain etc); (go ahead and do it) without hesitating;  
紧紧	緊緊	jǐn jǐn	closely; tightly;  
尽可能	盡可能	jǐn kě néng	as far as possible; to do one's utmost;  
进化	進化	jìn huà	evolution; CL:個|个[ge4];  
近来	近來	jìn lái	recently; lately;  
经费	經費	jīng fèi	funds; expenditure; CL:筆|笔[bi3];  
景象	景象	jǐng xiàng	scene; sight (to behold);  
警告	警告	jǐng gào	to warn; to admonish;  
竞赛	競賽	jìng sài	race; competition; CL:個|个[ge4];  
竞争	競爭	jìng zhēng	to compete; competition;  
酒鬼	酒鬼	jiǔ guǐ	drunkard;  
救灾	救災	jiù zāi	to relieve disaster; to help disaster victims;  
居然	居然	jū rán	unexpectedly; to one's surprise; go so far as to;  
局面	局麵	jú miàn	aspect; phase; situation;  
局长	局長	jú zhǎng	bureau chief; CL:位[wei4],個|个[ge4];  
举动	舉動	jǔ dòng	act; action; activity; move; movement;  
拒绝	拒絕	jù jué	to refuse; to decline; to reject;  
俱乐部	俱樂部	jù lè bù	club (the organisation or its premises) (loanword); CL:個|个[ge4];  
剧本	劇本	jù běn	script for play, opera, movie etc; screenplay; scenario;  
决不	決不	jué bù	not at all; simply (can) not;  
绝望	絕望	jué wàng	to despair; to give up all hope; desperate; desperation;  
军人	軍人	jūn rén	serviceman; soldier; military personnel;  
开幕	開幕	kāi mù	to open (a conference); to inaugurate;  
开幕式	開幕式	kāi mù shì	opening ceremony;  
看成	看成	kàn chéng	to regard as;  
看出	看齣	kàn chū	to make out; to see;  
看待	看待	kàn dài	to look upon; to regard;  
考核	考核	kǎo hé	to examine; to check up on; to assess; to review; appraisal; review; evaluation;  
烤肉	烤肉	kǎo roù	barbecue (lit. roast meat);  
烤鸭	烤鴨	kǎo yā	roast duck;  
靠近	靠近	kào jìn	near; to approach;  
颗	顆	kē	classifier for small spheres, pearls, corn grains, teeth, hearts, satellites etc;  
咳	咳	hāi, ké	sound of sighing;  cough;  
可	可	kě, kè	can; may; able to; to approve; to permit; to suit; (particle used for emphasis) certainly; very;  see 可汗[ke4 han2];  
可怜	可憐	kě lián	pitiful; pathetic; to have pity on;  
可惜	可惜	kě xī	it is a pity; what a pity; unfortunately;  
渴望	渴望	kě wàng	to thirst for; to long for;  
刻	刻	kè	quarter (hour); moment; to carve; to engrave; to cut; oppressive; classifier for short time intervals;  
客户	客戶	kè hù	client; customer;  
客气	客氣	kè qi	polite; courteous; formal; modest;  
客厅	客廳	kè tīng	drawing room (room for arriving guests); living room; CL:間|间[jian1];  
课题	課題	kè tí	task; problem; issue;  
肯定	肯定	kěn dìng	to be certain; to be positive; assuredly; definitely; to give recognition; to affirm; affirmative (answer);  
空中	空中	kōng zhōng	in the sky; in the air;  
控制	控製	kòng zhì	control; to exercise control over; to contain;  
口号	口號	koǔ hào	slogan; catchphrase; CL:個|个[ge4];  
库	庫	kù	warehouse; storehouse; (file) library;  
快活	快活	kuài huo	happy; cheerful;  
宽度	寬度	kuān dù	width;  
狂	狂	kuáng	mad; wild; violent;  
亏	虧	kuī	deficiency; deficit; luckily; it's lucky that...; (often ironically) fancy that...;  
困扰	睏擾	kùn rǎo	to perplex; to disturb; to cause complications;  
落	落	là, lào, luò	to leave out; to be missing; to leave behind or forget to bring; to lag or fall behind;  see 落枕[lao4 zhen3] and 落炕[lao4 kang4];  to fall or drop; (of the sun) to set; (of a tide) to go out; to lower; to decline or sink; to lag or fall behind; to fall onto; to rest with; to get or receive; to write down; whereabouts; settlement;  
来信	來信	lái xìn	incoming letter; send a letter here;  
烂	爛	làn	soft; mushy; well-cooked and soft; to rot; to decompose; rotten; worn out; chaotic; messy; utterly; thoroughly; crappy; bad;  
朗读	朗讀	lǎng dú	to read aloud;  
浪漫	浪漫	làng màn	romantic;  
劳动	勞動	láo dòng	work; toil; physical labor; CL:次[ci4];  
梨	梨	lí	pear; CL:個|个[ge4];  
礼	禮	Lǐ, lǐ	surname Li; abbr. for 禮記|礼记[Li3 ji4], Classic of Rites;  gift; rite; ceremony; CL:份[fen4]; propriety; etiquette; courtesy;  
礼拜	禮拜	lǐ bài	week; religious service; worship; CL:個|个[ge4];  
礼貌	禮貌	lǐ mào	courtesy; manners;  
厉害	厲害	lì hai	difficult to deal with; difficult to endure; ferocious; radical; serious; terrible; violent; tremendous; awesome;  
立	立	Lì, lì	surname Li;  to stand; to set up; to establish; to lay down; to draw up; at once; immediately;  
立场	立場	lì chǎng	position; standpoint; CL:個|个[ge4];  
利润	利潤	lì rùn	profits;  
例外	例外	lì wài	exception; to be an exception;  
连接	連接	lián jiē	to link; to join; to attach; connection; a link (on web page);  
联络	聯絡	lián luò	to get in touch with; to contact; to stay in contact (with); liaison; (math.) connection;  
联想	聯想	Lián xiǎng, lián xiǎng	abbr. for 聯想集團|联想集团[Lian2 xiang3 Ji2 tuan2];  to associate (cognitively); to make an associative connection; mental association; word prediction and auto-complete functions of input method editing programs;  
脸盆	臉盆	liǎn pén	washbowl; basin for washing hands and face; CL:個|个[ge4];  
脸色	臉色	liǎn sè	complexion; look;  
恋爱	戀愛	liàn ài	(romantic) love; CL:個|个[ge4],場|场[chang3]; in love; to have an affair;  
两岸	兩岸	liǎng àn	bilateral; both shores; both sides; both coasts; Taiwan and mainland;  
邻居	鄰居	lín jū	neighbor; next door; CL:個|个[ge4];  
铃	鈴	líng	(small) bell; CL:隻|只[zhi1];  
铃声	鈴聲	líng shēng	ring; ringtone; bell stroke; tintinnabulation;  
领带	領帶	lǐng dài	necktie; CL:條|条[tiao2];  
令	令	Líng, líng, lǐng, lìng	see 令狐[Ling2 hu2];  see 脊令[ji2 ling2];  classifier for a ream of paper;  to order; to command; an order; warrant; writ; to cause; to make sth happen; virtuous; honorific title; season; government position (old);  
流动	流動	liú dòng	to flow; to circulate; to go from place to place; to be mobile; (of assets) liquid;  
流通	流通	liú tōng	to circulate; to distribute; circulation; distribution;  
漏	漏	loù	to leak; to divulge; to leave out by mistake; waterclock or hourglass (old);  
漏洞	漏洞	loù dòng	leak; hole; gap; loophole;  
逻辑	邏輯	luó ji	logic (loanword);  
落实	落實	luò shí	practical; workable; to implement; to carry out; to decide;  
码头	碼頭	mǎ toú	dock; pier; wharf; CL:個|个[ge4];  
骂	罵	mà, mà	variant of 罵|骂[ma4];  
买卖	買賣	mǎi mài	buying and selling; business; business transactions; CL:樁|桩[zhuang1],次[ci4];  
漫长	漫長	màn cháng	very long; endless;  
漫画	漫畫	màn huà	caricature; cartoon; Japanese manga;  
毛笔	毛筆	máo bǐ	writing brush; CL:枝[zhi1],管[guan3];  
矛盾	矛盾	máo dùn	contradiction; CL:個|个[ge4]; conflicting views; contradictory;  
冒	冒	mào, Mào, mào	to emit; to give off; to send out (or up, forth); to brave; to face; reckless; to falsely adopt (sb's identity etc); to feign; (literary) to cover;  surname Mao;  
贸易	貿易	mào yì	(commercial) trade; CL:個|个[ge4];  
煤	煤	méi	coal; CL:塊|块[kuai4];  
煤气	煤氣	méi qì	coal gas; gas (fuel);  
门诊	門診	mén zhěn	outpatient service;  
迷人	迷人	mí rén	fascinating; enchanting; charming; tempting;  
迷信	迷信	mí xìn	superstition; to have a superstitious belief (in sth);  
面貌	麵貌	miàn mào	appearance; face; features; CL:個|个[ge4];  
面子	麵子	miàn zi	outer surface; outside; honor; reputation; face (as in 'losing face'); self-respect; feelings; (medicinal) powder;  
秒	秒	miǎo	second (of time); unit of angle or arc equivalent to one sixtieth of a degree;  
敏感	敏感	mǐn gǎn	sensitive; susceptible;  
明亮	明亮	míng liàng	bright; shining; glittering; to become clear;  
明明	明明	míng míng	obviously; plainly; undoubtedly; definitely;  
命令	命令	mìng lìng	order; command; CL:道[dao4],個|个[ge4];  
模范	模範	mó fàn	model; fine example;  
模仿	模仿	mó fǎng	to imitate; to copy; to emulate; to mimic; model;  
模糊	模糊	mó hu	vague; indistinct; fuzzy;  
模式	模式	mó shì	mode; method; pattern;  
摩擦	摩擦	mó cā	friction; rubbing; chafing; fig. disharmony; conflict; also written 磨擦;  
摩托	摩托	mó tuō	motor (loanword); motorbike;  
模样	模樣	mú yàng	look; style; appearance; approximation; about; CL:個|个[ge4]; also pr. [mo2 yang4];  
目光	目光	mù guāng	sight; vision; view; gaze; look;  
耐心	耐心	nài xīn	to be patient; patience;  
男性	男性	nán xìng	the male sex; a male;  
南北	南北	nán běi	north and south; north to south;  
南极	南極	nán jí	south pole;  
难得	難得	nán dé	seldom; rare; hard to come by;  
难以	難以	nán yǐ	hard to (predict, imagine etc);  
脑子	腦子	nǎo zi	brains; mind; CL:個|个[ge4];  
内在	內在	nèi zài	intrinsic; innate;  
能量	能量	néng liàng	energy; capabilities;  
年度	年度	nián dù	year (e.g. school year, fiscal year); annual;  
年龄	年齡	nián líng	(a person's) age; CL:把[ba3],個|个[ge4];  
年前	年前	nián qián	...years ago;  
牛	牛	Niú, niú	surname Niu;  ox; cow; bull; CL:條|条[tiao2],頭|头[tou2]; (slang) awesome;  
牛仔裤	牛仔褲	niú zǎi kù	jeans; CL:條|条[tiao2];  
农产品	農産品	nóng chǎn pǐn	agricultural produce;  
女性	女性	nǚ xìng	woman; the female sex;  
暖	暖	nuǎn, nuǎn, nuǎn, nuǎn	variant of 暖[nuan3], warm;  
偶尔	偶爾	oǔ ěr	occasionally; once in a while; sometimes;  
偶然	偶然	oǔ rán	incidentally; occasional; occasionally; by chance; randomly;  
偶像	偶像	oǔ xiàng	idol;  
拍摄	拍攝	pāi shè	to film; to shoot (a picture);  
排除	排除	pái chú	to eliminate; to remove; to exclude; to rule out;  
旁	旁	páng	beside; one side; other; side; self; the right-hand side of split Chinese character, often the phonetic;  
陪	陪	péi	to accompany; to keep sb company; to assist; old variant of 賠|赔[pei2];  
赔	賠	péi	to compensate for loss; to indemnify; to suffer a financial loss;  
赔偿	賠償	péi cháng	to compensate;  
配备	配備	pèi bèi	to allocate; to provide; to outfit with;  
配套	配套	pèi tào	to form a complete set; coherent;  
喷	噴	pēn, pèn	to puff; to spout; to spray; to spurt;  (of a smell) strong; peak season (of a crop); (classifier for the ordinal number of a crop, in the context of multiple harvests);  
盆	盆	pén	basin; flower pot; unit of volume equal to 12 斗 and 8 升, approx 128 liters; CL:個|个[ge4];  
披	披	pī	to drape over one's shoulders; to open; to unroll; to split open; to spread out;  
皮肤	皮膚	pí fū	skin; CL:層|层[ceng2],塊|块[kuai4];  
皮鞋	皮鞋	pí xié	leather shoes;  
脾气	脾氣	pí qi	character; temperament; disposition; bad temper; CL:個|个[ge4];  
匹	匹	pī, pǐ, pǐ	mate; one of a pair;  variant of 匹[pi3]; classifier for cloth: bolt;  
骗	騙	piàn	to cheat; to swindle; to deceive; to get on (a horse etc) by swinging one leg over;  
骗子	騙子	piàn zi	swindler; a cheat;  
拼	拼	pīn	to piece together; to join together; to stake all; adventurous; at the risk of one's life; to spell;  
频道	頻道	pín dào	frequency; (television) channel;  
频繁	頻繁	pín fán	frequently; often;  
品	品	pǐn	article; commodity; product; goods; kind; grade; rank; character; disposition; nature; temperament; variety; to taste sth; to sample; to criticize; to comment; to judge; to size up;  
品	品	pǐn	article; commodity; product; goods; kind; grade; rank; character; disposition; nature; temperament; variety; to taste sth; to sample; to criticize; to comment; to judge; to size up;  
品种	品種	pǐn zhǒng	breed; variety; CL:個|个[ge4];  
平坦	平坦	píng tǎn	level; even; smooth; flat;  
平原	平原	píng yuán	field; plain; CL:個|个[ge4];  
评估	評估	píng gū	to evaluate; to assess; assessment; evaluation;  
评论	評論	píng lùn	to comment on; to discuss; comment; commentary; CL:篇[pian1];  
凭	憑	píng, píng	to lean against; to rely on; on the basis of; no matter (how, what etc); proof;  
泼	潑	pō	to splash; to spill; rough and coarse; brutish;  
葡萄	葡萄	pú tao	grape;  
葡萄酒	葡萄酒	pú tao jiǔ	(grape) wine;  
期望	期望	qī wàng	to have expectations; to earnestly hope; expectation; hope;  
齐全	齊全	qí quán	complete;  
其	其	qí	his; her; its; their; that; such; it (refers to sth preceding it);  
启动	啓動	qǐ dòng	to start (a machine); to set in movement; to launch (an operation); to activate (a plan);  
启发	啓發	qǐ fā	to enlighten; to explain (a text etc); to stimulate (a mental attitude); enlightenment; revelation; motivation;  
启事	啓事	qǐ shì	announcement (written, on billboard, letter, newspaper or website); to post information; a notice;  
起到	起到	qǐdào	Play
起码	起碼	qǐ mǎ	at the minimum; at the very least;  
气体	氣體	qì tǐ	gas (i.e. gaseous substance);  
气象	氣象	qì xiàng	meteorological feature; CL:個|个[ge4]; meteorology; atmosphere; ambience; scene;  
签	簽	qiān, qiān, qiān	inscribed bamboo stick (used in divination, gambling, drawing lots etc); small wood sliver; label; tag;  
签订	簽訂	qiān dìng	to agree to and sign (a treaty etc);  
签名	簽名	qiān míng	to sign (one's name with a pen etc); to autograph; signature;  
签约	簽約	qiān yuē	to sign a contract or agreement;  
签证	簽證	qiān zhèng	visa; certificate; to certify; CL:個|个[ge4];  
签字	簽字	qiān zì	to sign (one's name); signature;  
前景	前景	qián jǐng	foreground; vista; (future) prospects; perspective;  
前提	前提	qián tí	premise; precondition; prerequisite;  
欠	欠	qiàn	deficient; to owe; to lack; yawn;  
枪	槍	Qiāng, qiāng, qiāng	surname Qiang;  variant of 槍|枪[qiang1]; rifle; spear;  
强度	強度	qiáng dù	strength; intensity; CL:個|个[ge4];  
墙壁	牆壁	qiáng bì	wall;  
抢	搶	qiāng, qiǎng	see 搶風|抢风[qiang1 feng1];  to fight over; to rush; to scramble; to grab; to rob; to snatch;  
抢救	搶救	qiǎng jiù	to rescue;  
强迫	強迫	qiǎng pò	to compel; to force;  
悄悄	悄悄	qiāo qiāo	quietly; secretly; stealthily; quiet; worried; Taiwan pr. [qiao3 qiao3];  
敲	敲	qiāo	to hit; to strike; to tap; to rap; to knock; to rip sb off; to overcharge;  
敲门	敲門	qiāo mén	to knock on a door;  
瞧	瞧	qiáo	to look at; to see; to see (a doctor); to visit;  
琴	琴	qín, qín	variant of 琴[qin2], guqin or zither;  
勤奋	勤奮	qín fèn	hardworking; diligent;  
青	青	Qīng, qīng	abbr. for 青海[Qing1 hai3], Qinghai Province;  nature's color; green or blue; greenish black; youth; young (of people);  
清晨	清晨	qīng chén	early morning;  
清理	清理	qīng lǐ	to clear up; to tidy up; to dispose of;  
情节	情節	qíng jié	plot; circumstances;  
情形	情形	qíng xing	circumstances; situation; CL:個|个[ge4];  
晴朗	晴朗	qíng lǎng	sunny and cloudless;  
区域	區域	qū yù	area; region; district;  
全都	全都	quán doū	all; without exception;  
全世界	全世界	quán shì jiè	worldwide; entire world;  
泉	泉	quán	spring (small stream); mouth of a spring; coin (archaic);  
劝	勸	quàn	to advise; to urge; to try to persuade; to exhort; to console; to soothe;  
缺乏	缺乏	quē fá	to lack; to be short of; lack; shortage;  
确立	確立	què lì	to establish; to institute;  
群体	群體	qún tǐ	community; colony;  
群众	群眾	qún zhòng	mass; multitude; the masses;  
染	染	rǎn	to dye; to catch (a disease); to acquire (bad habits etc); to contaminate; to add color washes to a painting;  
绕	繞	rào, rào	variant of 繞|绕[rao4], to rotate around; to spiral; to move around; to go round (an obstacle); to by-pass; to make a detour;  
热量	熱量	rè liàng	heat; quantity of heat; calorific value;  
热门	熱門	rè mén	popular; hot; in vogue;  
人间	人間	rén jiān	the human world; the earth;  
人力	人力	rén lì	manpower; labor power;  
人士	人士	rén shì	person; figure; public figure;  
人物	人物	rén wù	person; character (in a play, novel etc); protagonist; CL:個|个[ge4];  
忍	忍	rěn	to bear; to endure; to tolerate; to restrain oneself;  
忍不住	忍不住	rěn bu zhù	cannot help; unable to bear;  
忍受	忍受	rěn shoù	to bear; to endure;  
认	認	rèn	to recognize; to know; to admit;  
认定	認定	rèn dìng	to maintain (that sth is true); to determine (a fact); determination (of an amount); of the firm opinion; to believe firmly; to set one's mind on; to identify with;  
扔	扔	rēng	to throw; to throw away;  
仍旧	仍舊	réng jiù	still (remaining); to remain (the same); yet;  
如此	如此	rú cǐ	in this way; so;  
如同	如同	rú tóng	like; as;  
如下	如下	rú xià	as follows;  
入门	入門	rù mén	entrance door; to enter a door; introduction (to a subject);  
软	軟	ruǎn, ruǎn	variant of 軟|软[ruan3];  
软件	軟件	ruǎn jiàn	(computer) software;  
洒	灑	sǎ	to sprinkle; to spray; to spill; to shed;  
散	散	sàn, sǎn, sàn	to scatter; to break up (a meeting etc); to disperse; to disseminate; to dispel; (coll.) to sack;  scattered; loose; to come loose; to fall apart; leisurely; powdered medicine;  
散文	散文	sǎn wén	prose; essay;  
杀	殺	shā	to kill; to murder; to attack; to weaken or reduce; to smart (dialect); (used after a verb) extremely;  
杀毒	殺毒	shādú	Antivirus
沙漠	沙漠	shā mò	desert; CL:個|个[ge4];  
傻	傻	shǎ	foolish;  
山区	山區	shān qū	mountain area; CL:個|个[ge4];  
扇	扇	shān, shàn	to fan; to slap sb on the face;  fan; sliding, hinged or detachable flat part of sth; classifier for doors, windows etc;  
扇	扇	shān, shàn	to fan; to slap sb on the face;  fan; sliding, hinged or detachable flat part of sth; classifier for doors, windows etc;  
扇子	扇子	shàn zi	fan; CL:把[ba3];  
商标	商標	shāng biāo	trademark; logo;  
上级	上級	shàng jí	higher authorities; superiors; CL:個|个[ge4];  
上下	上下	shàng xià	up and down; top and bottom; old and new; length; about;  
上涨	上漲	shàng zhǎng	to rise; to go up;  
稍	稍	shāo, shào	somewhat; a little;  see 稍息[shao4 xi1];  
稍微	稍微	shāo wēi	a little bit;  
蛇	蛇	shé, shé	snake; serpent; CL:條|条[tiao2];  
舍不得	捨不得	shě bu de	to hate to do sth; to hate to part with; to begrudge;  
舍得	捨得	shě de	to be willing to part with sth;  
设想	設想	shè xiǎng	to imagine; to assume; to envisage; tentative plan; to have consideration for;  
社	社	shè	society; group; club; agency; (old) god of the land;  
社区	社區	shè qū	community;  
射	射	shè, shè	to shoot; to launch; to allude to; radio- (chemistry);  
射击	射擊	shè jī	to shoot; to fire (a gun);  
摄像	攝像	shè xiàng	to videotape;  
摄像机	攝像機	shè xiàng jī	video camera; CL:部[bu4];  
摄影	攝影	shè yǐng	to take a photograph; photography; to shoot (a movie);  
摄影师	攝影師	shè yǐng shī	photographer; cameraman;  
伸	伸	shēn	to stretch; to extend;  
深处	深處	shēn chù	abyss; depths; deepest or most distant part;  
深度	深度	shēn dù	depth; (of a speech etc) profundity; advanced stage of development;  
神	神	Shén, shén	God; abbr. for 神舟[Shen2 zhou1];  deity; soul; spirit; unusual; mysterious; lively; expressive; expression; look; CL:個|个[ge4]; (slang) awesome; amazing;  
神经	神經	shén jīng	nerve; mental state; (coll.) unhinged; nutjob;  
神奇	神奇	shén qí	magical; mystical; miraculous;  
神情	神情	shén qíng	look; expression;  
升高	升高	shēng gāo	to raise; to ascend;  
生成	生成	shēng chéng	to generate; to produce; generated; produced;  
声	聲	shēng	sound; voice; tone; noise; classifier for sounds;  
胜负	勝負	shèng fù	victory or defeat; the outcome of a battle;  
剩	剩	shèng	to remain; to be left; to have as remainder;  
剩下	剩下	shèng xià	to remain; left over;  
失误	失誤	shī wù	lapse; mistake; to make a mistake; fault; service fault (in volleyball, tennis etc);  
师傅	師傅	shī fu	master; qualified worker; respectful form of address for older men; CL:個|个[ge4],位[wei4],名[ming2];  
诗歌	詩歌	shī gē	poem; CL:本[ben3],首[shou3],段[duan4];  
十足	十足	shí zú	ample; complete; hundred percent; a pure shade (of some color);  
时常	時常	shí cháng	often; frequently;  
时光	時光	shí guāng	time; era; period of time;  
时机	時機	shí jī	fortunate timing; occasion; opportunity;  
时事	時事	shí shì	current trends; the present situation; how things are going;  
实惠	實惠	shí huì	tangible benefit; material advantages; cheap; economical; advantageous (deal); substantial (discount);  
拾	拾	shè, shí	to ascend in light steps;  to pick up; to collate or arrange; ten (banker's anti-fraud numeral);  
使得	使得	shǐ de	usable; workable; feasible; doable; to make; to cause;  
示范	示範	shì fàn	to demonstrate; to show how to do sth; demonstration; a model example;  
式	式	shì	type; form; pattern; style;  
势力	勢力	shì li	power; (ability to) influence;  
试图	試圖	shì tú	to attempt; to try;  
视频	視頻	shì pín	video;  
视为	視為	shì wéi	to view as; to see as; to consider to be; to deem;  
收购	收購	shoū goù	to purchase (from various places); to acquire (a company);  
收集	收集	shoū jí	to gather; to collect;  
收拾	收拾	shoū shi	to put in order; to tidy up; to pack; to repair; (coll.) to sort sb out; to fix sb;  
手段	手段	shoǔ duàn	method; means (of doing sth); strategy; trick; CL:個|个[ge4];  
手法	手法	shoǔ fǎ	technique; trick; skill;  
寿司	壽司	shoù sī	sushi;  
受灾	受災	shoù zāi	disaster-stricken; to be hit by a natural calamity;  
瘦	瘦	shoù	thin; to lose weight; (of clothing) tight; (of meat) lean; (of land) unproductive;  
书法	書法	shū fǎ	calligraphy; handwriting; penmanship;  
书柜	書櫃	shū guì	bookcase;  
书桌	書桌	shū zhuō	desk; CL:張|张[zhang1];  
输出	輸齣	shū chū	to export; to output;  
蔬菜	蔬菜	shū cài	vegetables; produce; CL:種|种[zhong3];  
熟悉	熟悉	shú xī	to be familiar with; to know well;  
鼠	鼠	shǔ	rat; mouse; CL:隻|只[zhi1];  
鼠标	鼠標	shǔ biāo	mouse (computing);  
数目	數目	shù mù	amount; number;  
摔	摔	shuāi	to throw down; to fall; to drop and break;  
摔倒	摔倒	shuāi dǎo	to fall down; to slip and fall; to throw sb to the ground;  
率领	率領	shuài lǐng	to lead; to command; to head;  
双手	雙手	shuāng shoǔ	both hands;  
水产品	水産品	shǔichǎnpǐn	Water products
水分	水分	shuǐ fèn	moisture content; (fig.) overstatement; padding;  
水库	水庫	shuǐ kù	reservoir; CL:座[zuo4];  
水灾	水災	shuǐ zāi	flood; flood damage;  
睡眠	睡眠	shuì mián	sleep; to sleep; (computing) to enter sleep mode;  
说法	說法	shuō fǎ, shuō fa	to expound Buddhist teachings;  way of speaking; wording; formulation; one's version (of events); statement; theory; hypothesis; interpretation;  
硕士	碩士	shuò shì	master's degree; person who has a master's degree; learned person;  
私人	私人	sī rén	private; personal; interpersonal; sb with whom one has a close personal relationship; a member of one's clique;  
思维	思維	sī wéi	(line of) thought; thinking;  
四周	四周	sì zhoū	all around;  
搜	搜	soū	to search;  
搜索	搜索	soū suǒ	to search (a place); to search (a database etc);  
宿舍	宿捨	sù shè	dormitory; dorm room; living quarters; hostel; CL:間|间[jian1];  
酸甜苦辣	酸甜苦辣	suān tián kǔ là	sour, sweet, bitter and spicy hot; fig. the joys and sorrows of life;  
随后	隨後	suí hoù	soon after;  
随意	隨意	suí yì	as one wishes; according to one's wishes; at will; voluntary; conscious;  
随着	隨著	suí zhe	along with; in the wake of; following;  
岁月	歲月	suì yuè	years; time;  
碎	碎	suì	to break down; to break into pieces; fragmentary;  
损害	損害	sǔn hài	harm; to damage; to impair;  
损失	損失	sǔn shī	loss; damage; CL:個|个[ge4]; to lose; to suffer damage;  
所在	所在	suǒ zài	place; location; whereabouts; domicile; to be located; to belong to (organization etc);  
锁	鎖	suǒ, suǒ	old variant of 鎖|锁[suo3];  
台风	颱風	tái fēng, tái fēng	hurricane; typhoon;  
抬	抬	tái	to lift; to raise; (of two or more persons) to carry;  
抬头	抬頭	tái toú	to raise one's head; to gain ground; account name, or space for writing the name on checks, bills etc;  
太空	太空	tài kōng	outer space;  
弹	彈	dàn, tán	crossball; bullet; shot; shell; ball;  to pluck (a string); to play (a string instrument); to spring or leap; to shoot (e.g. with a catapult); (of cotton) to fluff or tease; to flick; to flip; to accuse; to impeach; elastic (of materials);  
逃	逃	táo	to escape; to run away; to flee;  
逃跑	逃跑	táo pǎo	to flee from sth; to run away; to escape;  
逃走	逃走	táo zoǔ	to escape; to flee; to run away;  
桃	桃	táo	peach;  
桃花	桃花	táohuā	Peach flower
桃树	桃樹	táo shù	peach tree; CL:株[zhu1];  
讨厌	討厭	tǎo yàn	to dislike; to loathe; disagreeable; troublesome; annoying;  
特定	特定	tè dìng	special; specific; designated; particular;  
特性	特性	tè xìng	property; characteristic;  
特有	特有	tè yoǔ	specific (to); characteristic (of); distinctive;  
提倡	提倡	tí chàng	to promote; to advocate;  
提起	提起	tí qǐ	to mention; to speak of; to lift; to pick up; to arouse; to raise (a topic, a heavy weight, one's fist, one's spirits etc);  
提示	提示	tí shì	to point out; to remind (sb of sth); to suggest; suggestion; tip; reminder; notice;  
题材	題材	tí cái	subject matter;  
体积	體積	tǐ jī	volume; bulk; CL:個|个[ge4];  
体力	體力	tǐ lì	physical strength; physical power;  
天才	天纔	tiān cái	talent; gift; genius; talented; gifted;  
天然气	天然氣	tiān rán qì	natural gas;  
天文	天文	tiān wén	astronomy;  
调节	調節	tiáo jié	to adjust; to regulate; to harmonize; to reconcile (accountancy etc);  
调解	調解	tiáo jiě	to mediate; to bring parties to an agreement;  
厅	廳	tīng	(reception) hall; living room; office; provincial government department;  
停留	停留	tíng liú	to stay somewhere temporarily; to stop over;  
通用	通用	tōng yòng	common (use); interchangeable;  
偷	偷	toū	to steal; to pilfer; to snatch; thief; stealthily;  
偷偷	偷偷	toū toū	stealthily; secretly; covertly; furtively; on the sly;  
突破	突破	tū pò	to break through; to make a breakthrough; to surmount or break the back of (a task etc); (of ball sports) to break through a defense;  
土豆	土豆	tǔ doù	potato; CL:個|个[ge4]; (Tw) peanut; CL:顆|颗[ke1];  
吐	吐	tǔ, tù	to spit; to put; to say;  to vomit; to throw up;  
吐	吐	tǔ, tù	to spit; to put; to say;  to vomit; to throw up;  
兔	兔	tù, tù	rabbit;  
团长	團長	tuán zhǎng	regimental command; head of a delegation;  
推行	推行	tuī xíng	to put into effect; to carry out;  
脱离	脫離	tuō lí	to separate oneself from; to break away from; diastasis (medicine); abscission; abjunction (botany);  
外界	外界	wài jiè	the outside world; external;  
完了	完瞭	wán le	to be finished; to be done for; ruined; gone to the dogs; oh no;  
微博	微博	wēi bó	micro-blogging; microblog;  
为难	為難	wéi nán	to feel embarrassed or awkward; to make things difficult (for someone); to find things difficult (to do or manage);  
为期	為期	wéi qī	(to be done) by (a certain date); lasting (a certain time);  
为止	為止	wéi zhǐ	until; (used in combination with words like 到[dao4] or 至[zhi4] in constructs of the form 到...為止|到...为止);  
为主	為主	wéi zhǔ	to rely mainly on; to attach most importance to;  
违法	違法	wéi fǎ	illegal; to break the law;  
违反	違反	wéi fǎn	to violate (a law);  
违规	違規	wéi guī	to violate (rules); irregular; illegal; corrupt;  
围绕	圍繞	wéi rào	to revolve around; to center on (an issue);  
唯一	唯一	wéi yī	only; sole;  
委托	委托	wěi tuō	to entrust; to trust; to commission;  
卫星	衛星	wèi xīng	satellite; moon; CL:顆|颗[ke1];  
胃	胃	wèi	stomach; CL:個|个[ge4];  
慰问	慰問	wèi wèn	to express sympathy, greetings, consolation etc;  
温和	溫和	wēn hé, wēn huo	mild; gentle; moderate;  lukewarm;  
文艺	文藝	wén yì	literature and art;  
卧室	臥室	wò shì	bedroom; CL:間|间[jian1];  
握	握	wò	to hold; to grasp; to clench (one's fist); to master; classifier: a handful;  
污染	汙染	wū rǎn	pollution; contamination; CL:個|个[ge4];  
污水	汙水	wū shuǐ	sewage;  
屋	屋	wū	house; room; CL:間|间[jian1],個|个[ge4];  
无奈	無奈	wú nài	helpless; without choice; for lack of better option; grudgingly; willy-nilly; nolens volens; abbr. for 無可奈何|无可奈何[wu2 ke3 nai4 he2];  
无疑	無疑	wú yí	no doubt; undoubtedly;  
舞	舞	wǔ	to dance; to wield; to brandish;  
物价	物價	wù jià	(commodity) prices; CL:個|个[ge4];  
物业	物業	wù yè	property; real estate; abbr. for 物業管理|物业管理[wu4 ye4 guan3 li3], property management;  
物质	物質	wù zhì	matter; substance; material; materialistic; CL:個|个[ge4];  
误解	誤解	wù jiě	to misunderstand; to misread; misunderstanding;  
西红柿	西紅柿	xī hóng shì	tomato; CL:隻|只[zhi1];  
西装	西裝	xī zhuāng	suit; Western-style clothes; CL:套[tao4];  
喜剧	喜劇	xǐ jù	comedy; CL:部[bu4],出[chu1];  
戏	戲	xì, xì	trick; drama; play; show; CL:出[chu1],場|场[chang3],臺|台[tai2];  
戏剧	戲劇	xì jù	drama; play; theater;  
吓	嚇	hè, xià	to scare; to intimidate; to threaten; (interjection showing disapproval) tut-tut; (interjection showing astonishment);  to frighten; to scare;  
先后	先後	xiān hoù	early or late; priority; in succession; one after another;  
先前	先前	xiān qián	before; previously;  
鲜艳	鮮艷	xiān yàn	bright-colored; gaily-colored;  
闲	閑	xián, xián	variant of 閑|闲, idle; unoccupied; leisure; free time;  
显	顯	xiǎn	prominent; conspicuous; (prefix) phanero-;  
现有	現有	xiàn yoǔ	currently existing; currently available;  
现状	現狀	xiàn zhuàng	current situation;  
线索	綫索	xiàn suǒ	trail; clues; thread (of a story);  
献	獻	xiàn	to offer; to present; to dedicate; to donate; to show; to put on display; worthy person (old);  
乡	鄉	xiāng	country or countryside; native place; home village or town; township (PRC administrative unit);  
乡村	鄉村	xiāng cūn	rustic; village; countryside;  
相等	相等	xiāng děng	equal; equally; equivalent;  
相应	相應	xiāng yìng	to correspond; answering (one another); to agree (among the part); corresponding; relevant; appropriate; (modify) accordingly;  
香肠	香腸	xiāng cháng	sausage; CL:根[gen1];  
详细	詳細	xiáng xì	detailed; in detail; minute;  
享受	享受	xiǎng shoù	to enjoy; to live it up; pleasure; CL:種|种[zhong3];  
向导	嚮導	xiàng dǎo	guide;  
向前	嚮前	xiàng qián	forward; onward;  
向上	嚮上	xiàng shàng	upward; up; to advance; to try to improve oneself; to make progress;  
相声	相聲	xiàng sheng	comic dialog; sketch; crosstalk;  
象征	象徵	xiàng zhēng	emblem; symbol; token; badge; to symbolize; to signify; to stand for;  
消除	消除	xiāo chú	to eliminate; to remove;  
消毒	消毒	xiāo dú	to disinfect; to sterilize;  
消防	消防	xiāo fáng	firefighting; fire control;  
消费者	消費者	xiāo fèi zhě	consumer;  
消极	消極	xiāo jí	negative; passive; inactive;  
小偷儿	小偷兒	xiǎotōuér	Thief
歇	歇	xiē	to rest; to take a break; to stop; to halt; (dialect) to sleep; a moment; a short while;  
协议	協議	xié yì	agreement; pact; protocol; CL:項|项[xiang4];  
协议书	協議書	xié yì shū	contract; protocol;  
斜	斜	xié	inclined; slanting; oblique; tilting;  
心态	心態	xīn tài	attitude (of the heart); state of one's psyche; way of thinking; mentality;  
心疼	心疼	xīn téng	to love dearly; to feel sorry for sb; to regret; to grudge; to be distressed;  
辛苦	辛苦	xīn kǔ	hard; exhausting; with much toil; thanks for your trouble;  
欣赏	欣賞	xīn shǎng	to appreciate; to enjoy; to admire;  
信念	信念	xìn niàn	faith; belief; conviction;  
信箱	信箱	xìn xiāng	mailbox; post office box;  
行驶	行駛	xíng shǐ	to travel along a route (of vehicles etc);  
形态	形態	xíng tài	shape; form; pattern; morphology;  
性能	性能	xìng néng	function; performance;  
雄伟	雄偉	xióng wěi	grand; imposing; magnificent; majestic;  
熊	熊	Xióng, xióng	surname Xiong;  bear; to scold; to rebuke; brilliant light; to shine brightly;  
休闲	休閑	xiū xián	leisure; relaxation; not working; idle; to enjoy leisure; to lie fallow;  
修复	修復	xiū fù	to restore; to renovate; restoration; (computing) to fix (a bug);  
修建	修建	xiū jiàn	to build; to construct;  
修养	修養	xiū yǎng	accomplishment; training; self-cultivation;  
虚心	虛心	xū xīn	modest;  
许可	許可	xǔ kě	to allow; to permit;  
选修	選修	xuǎn xiū	optional course (in school); to take an optional course;  
学科	學科	xué kē	subject; branch of learning; course; academic discipline;  
学位	學位	xué wèi	academic degree; place in school;  
学者	學者	xué zhě	scholar;  
寻求	尋求	xún qiú	to seek; to look for;  
询问	詢問	xún wèn	to inquire;  
押金	押金	yā jīn	deposit; down payment;  
鸭子	鴨子	yā zi	duck; male prostitute (slang);  
亚军	亞軍	yà jūn	second place (in a sports contest); runner-up;  
延伸	延伸	yán shēn	to extend; to spread;  
严厉	嚴厲	yán lì	severe; strict;  
严肃	嚴肅	yán sù	solemn; grave; serious; earnest; severe;  
言语	言語	yán yǔ, yán yu	words; speech; (spoken) language;  to speak; to tell;  
研究所	研究所	yán jiū suǒ	research institute; graduate studies; graduate school; CL:個|个[ge4];  
眼光	眼光	yǎn guāng	gaze; insight; foresight; vision; way of looking at things;  
邀请	邀請	yāo qǐng	to invite; invitation; CL:個|个[ge4];  
摇头	搖頭	yáo toú	to shake one's head;  
咬	咬	yǎo, yǎo	variant of 咬[yao3];  
也好	也好	yěhǎo	Also
业务	業務	yè wù	business; professional work; service; CL:項|项[xiang4];  
夜间	夜間	yè jiān	nighttime; evening or night (e.g. classes);  
一流	一流	yī liú	top quality; front ranking;  
依法	依法	yī fǎ	legal (proceedings); according to law;  
依旧	依舊	yī jiù	as before; still;  
依据	依據	yī jù	according to; basis; foundation;  
依照	依照	yī zhào	according to; in light of;  
一辈子	一輩子	yī bèi zi	(for) a lifetime;  
一带	一帶	yī dài	region; district;  
一旦	一旦	yī dàn	in case (sth happens); if; once (sth happens, then...); when; in a short time; in one day;  
一句话	一句話	yī jù huà	in a word; in short;  
一路	一路	yī lù	the whole journey; all the way; going the same way; going in the same direction; of the same kind;  
一下儿	一下兒	yi1 xia4 r5	erhua variant of 一下[yi1 xia4];  
一下子	一下子	yī xià zi	in a short while; all at once; all of a sudden;  
一向	一嚮	yī xiàng	always (previously); a period of time in the recent past;  
乙	乙	yǐ, zhé	second of the ten Heavenly Stems 十天干[shi2 tian1 gan1]; second in order; letter 'B' or roman 'II' in list 'A, B, C', or 'I, II, III' etc; second party (in legal contract, usually 乙方[yi3 fang1], as opposed to 甲方[jia3 fang1]); ethyl; bent; winding; radical in Chinese characters (Kangxi radical 5); ancient Chinese compass point: 105°;  turning stroke (in Chinese characters); see also 折[zhe2];  
以便	以便	yǐ biàn	so that; so as to; in order to;  
以往	以往	yǐ wǎng	in the past; formerly;  
一口气	一口氣	yī koǔ qì	one breath; in one breath; at a stretch;  
一身	一身	yī shēn	whole body; from head to toe; single person; a suit of clothes;  
意识	意識	yì shí	consciousness; awareness; to be aware; to realize;  
意味着	意味著	yì wèi zhe	to signify; to mean; to imply;  
意志	意誌	yì zhì	will; willpower; determination; CL:個|个[ge4];  
因而	因而	yīn ér	therefore; as a result; thus; and as a result, ...;  
饮料	飲料	yǐn liào	drink; beverage;  
饮食	飲食	yǐn shí	food and drink; diet;  
印刷	印刷	yìn shuā	to print; printing;  
应	應	Yìng, yīng, yìng	surname Ying;  to agree (to do sth); should; ought to; must; (legal) shall;  to answer; to respond; to comply with; to deal or cope with;  
硬	硬	yìng	hard; stiff; strong; firm; resolutely; doggedly; good (quality); able (person);  
硬件	硬件	yìng jiàn	hardware;  
拥抱	擁抱	yōng bào	to embrace; to hug;  
拥有	擁有	yōng yoǔ	to have; to possess;  
用不着	用不著	yòng bu zháo	not need; have no use for;  
用户	用戶	yòng hù	user; consumer; subscriber; customer;  
用来	用來	yòng lái	to be used for;  
用于	用於	yòng yú	use in; use on; use for;  
优惠	優惠	yoū huì	preferential; favorable;  
优先	優先	yoū xiān	to have priority; to take precedence;  
幽默	幽默	yoū mò	(loanword) humor; humorous;  
尤其	尤其	yoú qí	especially; particularly;  
由此	由此	yoú cǐ	hereby; from this;  
犹豫	猶豫	yoú yù	to hesitate;  
游泳池	遊泳池	yoú yǒng chí	swimming pool; CL:場|场[chang3];  
友谊	友誼	yoǔ yì	companionship; fellowship; friendship;  
有毒	有毒	yoǔ dú	poisonous;  
有害	有害	yoǔ hài	destructive; harmful; damaging;  
有力	有力	yoǔ lì	powerful; forceful; vigorous;  
有利于	有利於	yǒulìyú	beneficial to
有着	有著	yoǔ zhe	to have; to possess;  
羽毛球	羽毛球	yǔ máo qiú	shuttlecock; badminton; CL:個|个[ge4];  
羽绒服	羽絨服	yǔ róng fú	down-filled garment;  
雨水	雨水	Yǔ shuǐ	Yushui or Rain Water, 2nd of the 24 solar terms 二十四節氣|二十四节气 19th February-5th March;  
预备	預備	yù bèi	to prepare; to make ready; preparation; preparatory;  
预期	預期	yù qī	to expect; to anticipate;  
元旦	元旦	Yuán dàn	New Year's Day;  
园林	園林	yuán lín	gardens; park; landscape garden;  
原理	原理	yuán lǐ	principle; theory;  
原始	原始	yuán shǐ	first; original; primitive; original (document etc);  
原先	原先	yuán xiān	originally; original; former;  
原有	原有	yuán yoǔ	original; former;  
远处	遠處	yuǎn chù	distant place;  
怨	怨	yuàn	to blame; to complain;  
愿	願	yuàn	to hope; to wish; to desire; hoped-for; ready; willing; sincere;  
约束	約束	yuē shù	to restrict; to limit to; to constrain; restriction; constraint;  
月饼	月餅	yuè bǐng	mooncake (esp. for the Mid-Autumn Festival);  
月球	月球	yuè qiú	the moon;  
阅览室	閱覽室	yuè lǎn shì	reading room; CL:間|间[jian1];  
运	運	yùn	to move; to transport; to use; to apply; fortune; luck; fate;  
运行	運行	yùn xíng	to move along one's course (of celestial bodies etc); (fig.) to function; to be in operation; (of a train service etc) to operate; to run; (of a computer) to run;  
灾	災	zāi, zāi, zāi	old variant of 災|灾[zai1];  
灾害	災害	zāi hài	calamity; disaster; CL:個|个[ge4];  
灾难	災難	zāi nàn	disaster; catastrophe;  
灾区	災區	zāi qū	disaster area; stricken region;  
再次	再次	zài cì	one more time; again; one more; once again;  
再也	再也	zài yě	(not) any more;  
在场	在場	zài chǎng	to be present; to be on the scene;  
在内	在內	zài nèi	(included) in it; among them;  
暂时	暫時	zàn shí	temporary; provisional; for the time being;  
暂停	暫停	zàn tíng	to suspend; time-out (e.g. in sports); stoppage; pause (media player);  
糟	糟	zāo	dregs; draff; pickled in wine; rotten; messy; ruined;  
糟糕	糟糕	zāo gāo	too bad; how terrible; what bad luck; terrible; bad;  
早期	早期	zǎo qī	early period; early phase; early stage;  
增	增	zēng	to increase; to expand; to add;  
增产	增産	zēng chǎn	to increase production;  
增大	增大	zēng dà	to enlarge; to amplify; to magnify;  
增多	增多	zēng duō	to increase; to grow in number;  
增强	增強	zēng qiáng	to increase; to strengthen;  
赠	贈	zèng	to give as a present; to repel; to bestow an honorary title after death (old);  
赠送	贈送	zèng sòng	to present as a gift;  
摘	摘	zhāi	to take; to borrow; to pick (flowers, fruit etc); to pluck; to select; to remove; to take off (glasses, hat etc);  
展览	展覽	zhǎn lǎn	to put on display; to exhibit; exhibition; show; CL:個|个[ge4],次[ci4];  
展示	展示	zhǎn shì	to reveal; to display; to show; to exhibit sth;  
展现	展現	zhǎn xiàn	to come out; to emerge; to reveal; to display;  
占领	占領	zhàn lǐng	to occupy (a territory); to hold;  
占有	占有	zhàn yoǔ	to have; to own; to hold; to occupy; to possess; to account for (a high proportion etc);  
涨	漲	zhǎng, zhàng	to rise (of prices, rivers);  to swell; to distend;  
涨价	漲價	zhǎng jià	to appreciate (in value); to increase in price;  
掌握	掌握	zhǎng wò	to grasp (often fig.); to control; to seize (initiative, opportunity, destiny); to master; to know well; to understand sth well and know how to use it; fluency;  
招生	招生	zhāo shēng	to enroll new students; to get students;  
招手	招手	zhāo shoǔ	to wave; to beckon;  
珍贵	珍貴	zhēn guì	precious;  
珍惜	珍惜	zhēn xī	to treasure; to value; to cherish;  
珍珠	珍珠	zhēn zhū	pearl; CL:顆|颗[ke1];  
真诚	真誠	zhēn chéng	true; sincere; genuine;  
真理	真理	zhēn lǐ	truth; CL:個|个[ge4];  
真相	真相	zhēn xiàng	the truth about sth; the actual facts;  
诊断	診斷	zhěn duàn	diagnosis; to diagnose;  
振动	振動	zhèn dòng	to vibrate; to shake; vibration;  
震惊	震驚	zhèn jīng	to shock; to astonish;  
争议	爭議	zhēng yì	controversy; dispute; to dispute;  
正版	正版	zhèng bǎn	genuine; legal; see also 盜版|盗版[dao4 ban3];  
正规	正規	zhèng guī	regular; according to standards;  
正如	正如	zhèng rú	just as; precisely as;  
正义	正義	zhèng yì	justice; righteousness; just; righteous;  
证实	證實	zhèng shí	to confirm (sth to be true); to verify;  
证书	證書	zhèng shū	credentials; certificate;  
挣	掙	zhēng, zhèng	see 掙扎|挣扎[zheng1 zha2];  to struggle to get free; to strive to acquire; to make (money);  
挣钱	掙錢	zhèng qián	to make money;  
之内	之內	zhī nèi	inside; within;  
之外	之外	zhī wài	outside; excluding;  
之下	之下	zhī xià	under; beneath; less than;  
之中	之中	zhī zhōng	inside; among; in the midst of (doing sth); during;  
支出	支齣	zhī chū	to spend; to pay out; expense;  
支配	支配	zhī pèi	to control; to dominate; to allocate;  
执行	執行	zhí xíng	to implement; to carry out; to execute; to run;  
直线	直綫	zhí xiàn	straight line; sharply (rise or fall);  
值班	值班	zhí bān	to work a shift; on duty;  
职能	職能	zhí néng	function; role;  
职位	職位	zhí wèi	post; office; position;  
职务	職務	zhí wù	post; position; job; duties;  
只不过	隻不過	zhǐ bu guò, zhǐ bù guò	only; merely; nothing but; no more than;  it's just that ...;  
只见	隻見	zhǐjiàn	Only see
指标	指標	zhǐ biāo	(production) target; quota; index; indicator; sign; signpost; (computing) pointer;  
指甲	指甲	zhǐ jia	fingernail;  
指示	指示	zhǐ shì	to point out; to indicate; to instruct; directives; instructions; CL:個|个[ge4];  
指责	指責	zhǐ zé	to criticize; to find fault with; to denounce;  
至	至	zhì	to arrive; most; to; until;  
制成	製成	zhì chéng	to manufacture; to turn out (a product);  
制约	製約	zhì yuē	to restrict; condition;  
治安	治安	zhì ān	law and order; public security;  
治理	治理	zhì lǐ	to govern; to administer; to manage; to control; governance;  
中断	中斷	zhōng duàn	to cut short; to break off; to discontinue; to interrupt;  
中秋节	中鞦節	Zhōng qiū jié	the Mid-Autumn Festival on 15th of 8th lunar month;  
中央	中央	zhōng yāng	central; middle; center; central authorities (of a state);  
中药	中藥	Zhōng yào	(traditional) Chinese medicine; CL:服[fu4],種|种[zhong3];  
终点	終點	zhōng diǎn	the end; end point; finishing line (in a race); destination; terminus; CL:個|个[ge4];  
终身	終身	zhōng shēn	lifelong; all one's life; marriage;  
终止	終止	zhōng zhǐ	to stop; to terminate (law);  
中毒	中毒	zhòng dú	to be poisoned; poisoning;  
众多	眾多	zhòng duō	numerous;  
周期	周期	zhoū qī	period; cycle;  
竹子	竹子	zhú zi	bamboo; CL:棵[ke1],支[zhi1],根[gen1];  
主办	主辦	zhǔ bàn	to organize; to host (a conference or sports event);  
主导	主導	zhǔ dǎo	leading; dominant; prevailing; to lead; to direct; to dominate;  
主观	主觀	zhǔ guān	subjective;  
主管	主管	zhǔ guǎn	in charge; responsible for; person in charge; manager;  
主体	主體	zhǔ tǐ	main part; bulk; body; subject; agent;  
助理	助理	zhù lǐ	assistant;  
助手	助手	zhù shoǔ	assistant; helper;  
注册	注冊	zhù cè	to register; to enroll;  
注射	注射	zhù shè	injection; to inject;  
注视	注視	zhù shì	to watch attentively; to gaze at;  
注重	注重	zhù zhòng	to pay attention to; to emphasize;  
祝贺	祝賀	zhù hè	to congratulate; congratulations; CL:個|个[ge4];  
专辑	專輯	zhuān jí	album; record (music); special collection of printed or broadcast material;  
专利	專利	zhuān lì	patent; sth uniquely enjoyed (or possessed etc) by a certain group of people; monopoly;  
转化	轉化	zhuǎn huà	to change; to transform; isomerization (chemistry);  
转换	轉換	zhuǎn huàn	to change; to switch; to convert; to transform;  
转让	轉讓	zhuǎn ràng	transfer (technology, goods etc); conveyancing (property);  
转向	轉嚮	zhuǎn xiàng, zhuàn xiàng	to change direction; fig. to change one's stance;  to get lost; to lose one's way;  
装饰	裝飾	zhuāng shì	to decorate; decoration; decorative; ornamental;  
撞	撞	zhuàng	to knock against; to bump into; to run into; to meet by accident;  
资本	資本	zī běn	capital (economics);  
资产	資産	zī chǎn	property; assets;  
资助	資助	zī zhù	to subsidize; to provide financial aid; subsidy;  
子弹	子彈	zǐ dàn	bullet; CL:粒[li4],顆|颗[ke1],發|发[fa1];  
仔细	仔細	zǐ xì	careful; attentive; cautious;  
紫	紫	zǐ	purple; violet; amethyst; Lithospermum erythrorhizon (flowering plant whose root provides red purple dye); Japanese: murasaki;  
自豪	自豪	zì háo	proud (of one's achievements etc);  
自杀	自殺	zì shā	to kill oneself; to commit suicide; to attempt suicide;  
自愿	自願	zì yuàn	voluntary;  
总裁	總裁	zǒng cái	chairman; director-general (of a company etc);  
总数	總數	zǒng shù	total; sum; aggregate;  
总算	總算	zǒng suàn	at long last; finally; on the whole;  
总体	總體	zǒng tǐ	completely; totally; total; entire; overall; population (statistics);  
阻碍	阻礙	zǔ ài	to obstruct; to hinder; to block; obstruction; hindrance;  
组织	組織	zǔ zhī	to organize; organization; organized system; nerve; tissue; CL:個|个[ge4];  
醉	醉	zuì	intoxicated;  
尊敬	尊敬	zūn jìng	to respect; to revere;  
尊重	尊重	zūn zhòng	to esteem; to respect; to honor; to value; eminent; serious; proper;  
遵守	遵守	zūn shoǔ	to comply with; to abide by; to respect (an agreement);  
