阿姨	阿姨	ā yí	maternal aunt; step-mother; childcare worker; nursemaid; woman of similar age to one's parents (term of address used by child); CL:個|个[ge4];  
啊	啊	ā, á, ǎ, à, a	interjection of surprise; Ah!; Oh!;  interjection expressing doubt or requiring answer; Eh?; what?;  interjection of surprise or doubt; Eh?; My!; what's up?;  interjection or grunt of agreement; uhm; Ah, OK; expression of recognition; Oh, it's you!;  modal particle ending sentence, showing affirmation, approval, or consent;  
矮	矮	ǎi	low; short (in length);  
矮小	矮小	ǎi xiǎo	short and small; low and small; undersized;  
爱国	愛國	ài guó	to love one's country; patriotic;  
爱护	愛護	ài hù	to cherish; to treasure; to take care of; to love and protect;  
安	安	Ān, ān	surname An;  content; calm; still; quiet; safe; secure; in good health; to find a place for; to install; to fix; to fit; to bring (a charge against sb); to pacify; to harbor (good intentions); security; safety; peace; ampere;  
安置	安置	ān zhì	to find a place for; to help settle down; to arrange for; to get into bed; placement;  
按时	按時	àn shí	on time; before deadline; on schedule;  
暗	暗	àn, àn, àn	to close (a door); to eclipse; muddled; stupid; ignorant; variant of 暗[an4];  
暗示	暗示	àn shì	to hint; to suggest; suggestion; hint;  
巴士	巴士	bā shì	bus (loanword); motor coach;  
百货	百貨	bǎi huò	general merchandise;  
摆	擺	bǎi	to arrange; to exhibit; to move to and fro; a pendulum;  
摆动	擺動	bǎi dòng	to sway; to swing; to move back and forth; to oscillate;  
摆脱	擺脫	bǎi tuō	to break away from; to cast off (old ideas etc); to get rid of; to break away (from); to break out (of); to free oneself from; to extricate oneself;  
败	敗	bài	to defeat; to damage; to lose (to an opponent); to fail; to wither;  
办事	辦事	bàn shì	to handle (affairs); to work;  
包裹	包裹	bāo guǒ	to wrap up; to bind up; bundle; parcel; package; CL:個|个[ge4];  
包含	包含	bāo hán	to contain; to embody; to include;  
包括	包括	bāo kuò	to comprise; to include; to involve; to incorporate; to consist of;  
薄	薄	Bó, báo, bó, bò	surname Bo;  thin; cold in manner; indifferent; weak; light; infertile;  meager; slight; weak; ungenerous or unkind; frivolous; to despise; to belittle; to look down on; to approach or near;  see 薄荷[bo4 he5];  
宝	寶	bǎo, bǎo	jewel; gem; treasure; precious;  
宝宝	寶寶	bǎo bǎo	darling; baby;  
宝贝	寶貝	bǎo bèi	treasured object; treasure; darling; baby; cowry; good-for-nothing or queer character;  
宝贵	寶貴	bǎo guì	valuable; precious; to value; to treasure; to set store by;  
宝石	寶石	bǎo shí	precious stone; gem; CL:枚[mei2],顆|颗[ke1];  
保密	保密	bǎo mì	to keep sth confidential; to maintain secrecy;  
保守	保守	bǎo shoǔ	conservative; to guard; to keep;  
抱	抱	bào	to hold; to carry (in one's arms); to hug; to embrace; to surround; to cherish;  
背景	背景	bèi jǐng	background; backdrop; context; (fig.) powerful backer; CL:種|种[zhong3];  
倍	倍	bèi	(two, three etc) -fold; times (multiplier); double; to increase or multiply;  
被迫	被迫	bèi pò	to be compelled; to be forced;  
本科	本科	běn kē	undergraduate course; undergraduate (attributive);  
笨	笨	bèn	stupid; foolish; silly; slow-witted; clumsy;  
比分	比分	bǐ fēn	score;  
毕业	畢業	bì yè	graduation; to graduate; to finish school;  
毕业生	畢業生	bì yè shēng	graduate;  
避	避	bì	to avoid; to shun; to flee; to escape; to keep away from; to leave; to hide from;  
避免	避免	bì miǎn	to avert; to prevent; to avoid; to refrain from;  
编	編	biān	to weave; to plait; to organize; to group; to arrange; to edit; to compile; to write; to compose; to fabricate;  
辩论	辯論	biàn lùn	debate; argument; to argue over; CL:場|场[chang3],次[ci4];  
标志	標誌	biāo zhì	sign; mark; symbol; logo; to symbolize; to indicate; to mark;  
表情	錶情	biǎo qíng	(facial) expression; to express one's feelings; expression;  
表扬	錶揚	biǎo yáng	to praise; to commend;  
别	彆	Bié, bié, biè	surname Bie;  to leave; to depart; to separate; to distinguish; to classify; other; another; don't ...!; to pin; to stick (sth) in;  to make sb change their ways, opinions etc;  
冰	冰	bīng, bīng	variant of 冰[bing1];  
冰箱	冰箱	bīng xiāng	icebox; freezer cabinet; refrigerator; CL:臺|台[tai2],個|个[ge4];  
冰雪	冰雪	bīng xuě	ice and snow;  
兵	兵	bīng	soldiers; a force; an army; weapons; arms; military; warlike; CL:個|个[ge4];  
并	並	bìng, bìng, bìng	variant of 並|并[bing4];  
不要紧	不要緊	bù yào jǐn	unimportant; not serious; it doesn't matter; never mind; it looks all right, but;  
不在乎	不在乎	bù zài hu	not to care;  
不管	不管	bù guǎn	no matter (what, how); regardless of; no matter;  
不然	不然	bù rán	not so; no; or else; otherwise; if not; How about ...?;  
布置	布置	bù zhì	to put in order; to arrange; to decorate; to fix up; to deploy;  
步行	步行	bù xíng	to go on foot; to walk;  
擦	擦	cā	to wipe; to erase; rubbing (brush stroke in painting); to clean; to polish;  
才	纔	cái, cái	a moment ago; just now; (indicating sth happening later than expected); (preceded by a clause of condition or reason) not until; (followed by a numerical clause) only;  
材料	材料	cái liào	material; data; makings; stuff; CL:個|个[ge4],種|种[zhong3];  
财产	財産	cái chǎn	property; assets; estate; CL:筆|笔[bi3];  
财富	財富	cái fù	wealth; riches;  
采访	采訪	cǎi fǎng	to interview; to gather news; to hunt for and collect; to cover;  
参考	參考	cān kǎo	consultation; reference; to consult; to refer;  
参与	參與	cān yù	to participate (in sth);  
操场	操場	cāo chǎng	playground; sports field; drill ground; CL:個|个[ge4];  
操作	操作	cāo zuò	to work; to operate; to manipulate;  
测	測	cè	to survey; to measure; to conjecture;  
测量	測量	cè liáng	survey; to measure; to gauge; to determine;  
测试	測試	cè shì	to test (machinery etc); to test (students); test; quiz; exam; beta (software);  
曾	曾	Zēng, céng, zēng	surname Zeng;  once; already; ever (in the past); former; previously; (past tense marker used before verb or clause);  great-grand (father, child etc);  
茶叶	茶葉	chá yè	tea; tea leaves; CL:盒[he2],罐[guan4],包[bao1],片[pian4];  
产品	産品	chǎn pǐn	goods; merchandise; product; CL:個|个[ge4];  
长途	長途	cháng tú	long distance;  
常识	常識	cháng shí	common sense; general knowledge; CL:門|门[men2];  
唱片	唱片	chàng piàn	gramophone record; LP; CL:張|张[zhang1];  
抄	抄	chāo	to make a copy; to plagiarize; to search and seize; to raid; to grab; to go off with; to take a shortcut; to make a turning move; to fold one's arms;  
抄写	抄寫	chāo xiě	to copy; to transcribe;  
潮	潮	cháo	tide; current; damp; moist; humid;  
潮流	潮流	cháo liú	tide; current; trend;  
潮湿	潮濕	cháo shī	damp; moist;  
彻底	徹底	chè dǐ	thorough; thoroughly; complete;  
沉	沉	chēn, chén	see 黑沉沉[hei1 chen1 chen1];  to submerge; to immerse; to sink; to keep down; to lower; to drop; deep; profound; heavy;  
沉默	沉默	chén mò	taciturn; uncommunicative; silent;  
沉重	沉重	chén zhòng	heavy; hard; serious; critical;  
称赞	稱贊	chēng zàn	to praise; to acclaim; to commend; to compliment;  
成人	成人	chéng rén	adult;  
诚实	誠實	chéng shí	honest; honesty; honorable; truthful;  
诚信	誠信	chéng xìn	genuine; honest; in good faith; honesty; integrity;  
承担	承擔	chéng dān	to undertake; to assume (responsibility etc);  
承认	承認	chéng rèn	to admit; to concede; to recognize; recognition (diplomatic, artistic etc); to acknowledge;  
承受	承受	chéng shoù	to bear; to support; to inherit;  
程序	程序	chéng xù	procedures; sequence; order; computer program;  
吃惊	吃驚	chī jīng	to be startled; to be shocked; to be amazed;  
迟到	遲到	chí dào	to arrive late;  
尺	尺	chě, chǐ	one of the characters used to represent a musical note in gongche notation, 工尺譜|工尺谱[gong1 che3 pu3];  a Chinese foot; one-third of a meter; a ruler; a tape-measure; one of the three acupoints for measuring pulse in Chinese medicine; CL:支[zhi1],把[ba3];  
尺寸	尺寸	chǐ cun	size; dimension; measurement;  
尺子	尺子	chǐ zi	rule; ruler (measuring instrument); CL:把[ba3];  
冲	衝	chōng, chōng, chòng	thoroughfare; to go straight ahead; to rush; to clash;  powerful; vigorous; pungent; towards; in view of;  
充电	充電	chōng diàn	to recharge batteries; fig. to rest and recuperate;  
充电器	充電器	chōng diàn qì	battery charger;  
充分	充分	chōng fèn	ample; sufficient; adequate; full; fully; to the full;  
虫子	蟲子	chóng zi	insect; bug; worm; CL:條|条[tiao2],隻|只[zhi1];  
抽	抽	choū	to draw out; to pull out from in between; to remove part of the whole; (of certain plants) to sprout or bud; to whip or thrash;  
抽奖	抽奬	choū jiǎng	to draw a prize; a lottery; a raffle;  
抽烟	抽煙	choū yān	to smoke (a cigarette, tobacco);  
出口	齣口	chū koǔ	an exit; CL:個|个[ge4]; to speak; to export; (of a ship) to leave port;  
出色	齣色	chū sè	remarkable; outstanding;  
出售	齣售	chū shoù	to sell; to offer for sale; to put on the market;  
出席	齣席	chū xí	to attend; to participate; present;  
处于	處於	chǔ yú	to be in (some state, position, or condition);  
处	處	chǔ, chù	to reside; to live; to dwell; to be in; to be situated at; to stay; to get along with; to be in a position of; to deal with; to discipline; to punish;  place; location; spot; point; office; department; bureau; respect; classifier for locations or items of damage: spot, point;  
穿上	穿上	chuān shang	to put on (clothes etc);  
传统	傳統	chuán tǒng	tradition; traditional; convention; conventional; CL:個|个[ge4];  
窗户	窗戶	chuāng hu	window; CL:個|个[ge4],扇[shan4];  
窗台	窗颱	chuāng tái	window sill; window ledge;  
窗子	窗子	chuāng zi	window;  
春季	春季	chūn jì	springtime;  
纯	純	chún	pure; simple; unmixed; genuine;  
纯净水	純淨水	chúnjìngshǔi	pure water
词汇	詞匯	cí huì, cí huì	vocabulary; list of words (e.g. for language teaching purposes); word;  
此	此	cǐ	this; these;  
此外	此外	cǐ wài	besides; in addition; moreover; furthermore;  
次	次	cì	next in sequence; second; the second (day, time etc); secondary; vice-; sub-; infra-; inferior quality; substandard; order; sequence; hypo- (chemistry); classifier for enumerated events: time;  
刺	刺	cī, cì	(onom.) whoosh;  thorn; sting; thrust; to prick; to pierce; to stab; to assassinate; to murder;  
刺激	刺激	cì jī	to provoke; to irritate; to upset; to stimulate; to excite; irritant;  
从此	從此	cóng cǐ	from now on; since then; henceforth;  
粗	粗	cū, cū, cū	remote; distant; variant of 粗[cu1];  
粗心	粗心	cū xīn	careless; thoughtless;  
促进	促進	cù jìn	to promote (an idea or cause); to advance; boost;  
促使	促使	cù shǐ	to induce; to promote; to urge; to impel; to bring about; to provoke; to drive (sb to do sth); to catalyze; to actuate; to contribute to (some development);  
促销	促銷	cù xiāo	to promote sales;  
措施	措施	cuò shī	measure; step; CL:個|个[ge4];  
打	打	dá, dǎ	dozen (loanword);  to beat; to strike; to hit; to break; to type; to mix up; to build; to fight; to fetch; to make; to tie up; to issue; to shoot; to calculate; to play (a game); since; from;  
答案	答案	dá àn	answer; solution; CL:個|个[ge4];  
打败	打敗	dǎ bài	to defeat; to overpower; to beat; to be defeated;  
打雷	打雷	dǎ léi	to rumble with thunder; clap of thunder;  
打扫	打掃	dǎ sǎo	to clean; to sweep;  
打折	打摺	dǎ zhé	to give a discount;  
打针	打針	dǎ zhēn	to give or have an injection;  
大巴	大巴	dà bā	a big coach; tourist bus;  
大多	大多	dà duō	for the most part; many; most; the greater part; mostly;  
大方	大方	dà fāng, dà fang	expert; scholar; mother earth; a type of green tea;  generous; magnanimous; stylish; in good taste; easy-mannered; natural and relaxed;  
大哥	大哥	dà gē	eldest brother; big brother (polite address for a man of about the same age as oneself); gang leader; boss;  
大规模	大規模	dà guī mó	large scale; extensive; wide scale; broad scale;  
大会	大會	dà huì	general assembly; general meeting; convention; CL:個|个[ge4],屆|届[jie4];  
大姐	大姐	dà jiě	big sister; elder sister; older sister (also polite term of address for a girl or woman slightly older than the speaker);  
大楼	大樓	dà loú	building (a relatively large, multi-storey one); CL:幢[zhuang4],座[zuo4];  
大陆	大陸	Dà lù, dà lù	mainland China (reference to the PRC);  continent; mainland; CL:個|个[ge4],塊|块[kuai4];  
大妈	大媽	dà mā	father's elder brother's wife; aunt (affectionate term for an elderly woman);  
大型	大型	dà xíng	large; large-scale;  
大爷	大爺	dà yé, dà ye	arrogant idler; self-centered show-off;  (coll.) father's older brother; uncle; term of respect for older man;  
大众	大眾	Dà zhòng, dà zhòng	Volkswagen (automobile manufacturer);  the masses; the great bulk of the population; popular (of music, science etc);  
代替	代替	dài tì	to replace; to take the place of;  
待遇	待遇	dài yù	treatment; pay; salary; status; rank;  
袋	袋	dài	pouch; bag; sack; pocket;  
戴	戴	Dài, dài	surname Dai;  to put on or wear (glasses, hat, gloves etc); to respect; to bear; to support;  
担保	擔保	dān bǎo	to guarantee; to vouch for;  
担任	擔任	dān rèn	to hold a governmental office or post; to assume office of; to take charge of; to serve as;  
担心	擔心	dān xīn	anxious; worried; uneasy; to worry; to be anxious;  
单	單	Shàn, dān	surname Shan;  bill; list; form; single; only; sole; odd number; CL:個|个[ge4];  
单纯	單純	dān chún	simple; pure; unsophisticated; merely; purely;  
单调	單調	dān diào	monotonous;  
单独	單獨	dān dú	alone; by oneself; on one's own;  
淡	淡	dàn	insipid; diluted; weak; mild; light in color; tasteless; fresh; indifferent; nitrogen;  
导游	導遊	dǎo yoú	tour guide; guidebook; to conduct a tour;  
导致	導緻	dǎo zhì	to lead to; to create; to cause; to bring about;  
倒闭	倒閉	dǎo bì	to go bankrupt; to close down;  
倒车	倒車	dǎo chē, dào chē	to change buses, trains etc;  to reverse (a vehicle); to drive backwards;  
倒车	倒車	dǎo chē, dào chē	to change buses, trains etc;  to reverse (a vehicle); to drive backwards;  
得意	得意	dé yì	proud of oneself; pleased with oneself; complacent;  
得	得	dé, de, děi	to obtain; to get; to gain; to catch (a disease); proper; suitable; proud; contented; to allow; to permit; ready; finished;  structural particle: used after a verb (or adjective as main verb), linking it to following phrase indicating effect, degree, possibility etc;  to have to; must; ought to; to need to;  
灯光	燈光	dēng guāng	(stage) lighting; light;  
登	登	dēng	to scale (a height); to ascend; to mount; to publish or record; to enter (e.g. in a register); to press down with the foot; to step or tread on; to put on (shoes or trousers) (dialect); to be gathered and taken to the threshing ground (old);  
登记	登記	dēng jì	to register (one's name);  
登录	登錄	dēng lù	to register; to log in;  
登山	登山	dēng shān	to climb a mountain; climbing; mountaineering;  
的确	的確	dí què	really; indeed;  
敌人	敵人	dí rén	enemy; CL:個|个[ge4];  
底	底	de, dǐ	(equivalent to 的 as possessive particle);  background; bottom; base; end (of the month, year etc); remnants; (math.) radix; base;  
地方	地方	dì fāng, dì fang	region; regional (away from the central administration); local;  area; place; space; room; territory; CL:處|处[chu4],個|个[ge4],塊|块[kuai4];  
地面	地麵	dì miàn	floor; ground; surface;  
地位	地位	dì wèi	position; status; place; CL:個|个[ge4];  
地下	地下	dì xià	underground; subterranean; covert;  
地址	地址	dì zhǐ	address; CL:個|个[ge4];  
典型	典型	diǎn xíng	model; typical case; archetype; typical; representative;  
点名	點名	diǎn míng	roll call; to mention sb by name; (to call or praise or criticize sb) by name;  
电灯	電燈	diàn dēng	electric light; CL:盞|盏[zhan3];  
电动车	電動車	diàndòngchē	Electric vehicle
电梯	電梯	diàn tī	elevator; escalator; CL:臺|台[tai2],部[bu4];  
电源	電源	diàn yuán	electric power source;  
顶	頂	dǐng	apex; crown of the head; top; roof; most; to carry on the head; to push to the top; to go against; to replace; to substitute; to be subjected to (an aerial bombing, hailstorm etc); (slang) to 'bump' a forum thread to raise its profile; classifier for headwear, hats, veils etc;  
定	定	dìng	to set; to fix; to determine; to decide; to order;  
冬季	鼕季	dōng jì	winter;  
动画片	動畫片	dòng huà piàn	animated film;  
动摇	動搖	dòng yáo	to sway; to waver; to rock; to rattle; to destabilize; to pose a challenge to;  
豆腐	豆腐	doù fu	tofu; bean curd;  
独立	獨立	dú lì	independent; independence; to stand alone;  
独特	獨特	dú tè	unique; distinct; having special characteristics;  
独自	獨自	dú zì	alone;  
堵	堵	dǔ	to stop up; (to feel) stifled or suffocated; wall; classifier for walls;  
堵车	堵車	dǔ chē	traffic jam; choking;  
肚子	肚子	dù zi	belly; abdomen; stomach; CL:個|个[ge4];  
度过	度過	dù guò	to pass; to spend (time); to survive; to get through;  
锻炼	鍛煉	duàn liàn	to toughen; to temper; to engage in physical exercise; to work out; (fig.) to develop one's skills; to train oneself;  
对比	對比	duì bǐ	to contrast; contrast; ratio; CL:個|个[ge4];  
对付	對付	duì fu	to handle; to deal with; to cope; to get by with;  
对于	對於	duì yú	regarding; as far as sth is concerned; with regards to;  
多次	多次	duō cì	many times; repeatedly;  
多年	多年	duōnián	for many years
多样	多樣	duō yàng	diverse; diversity; manifold;  
多种	多種	duō zhǒng	many kinds of; multiple; diverse; multi-;  
恶心	惡心	ě xīn, ě xīn, è xīn	nausea; to feel sick; disgust; nauseating; to embarrass (deliberately);  bad habit; vicious habit; vice;  
儿童	兒童	ér tóng	child; CL:個|个[ge4];  
而	而	ér	and; as well as; and so; but (not); yet (not); (indicates causal relation); (indicates change of state); (indicates contrast);  
而是	而是	ér shì	rather;  
耳机	耳機	ěr jī	headphones; earphones; telephone receiver;  
二手	二手	èr shoǔ	indirectly acquired; second-hand (information, equipment etc); assistant;  
发挥	發揮	fā huī	to display; to exhibit; to bring out implicit or innate qualities; to express (a thought or moral); to develop (an idea); to elaborate (on a theme);  
发票	發票	fā piào	invoice; receipt or bill for purchase;  
发烧	發燒	fā shāo	to have a high temperature (from illness); to have a fever;  
法	法	fǎ, Fǎ, fǎ, fǎ	old variant of 法[fa3]; law;  France; French; abbr. for 法國|法国[Fa3 guo2]; Taiwan pr. [Fa4];  
法官	法官	fǎ guān	judge;  
法律	法律	fǎ lǜ	law; CL:條|条[tiao2], 套[tao4], 個|个[ge4];  
法院	法院	fǎ yuàn	court of law; court;  
翻	翻	fān, fān	variant of 翻[fan1];  
翻译	翻譯	fān yì	to translate; to interpret; translator; interpreter; translation; interpretation; CL:個|个[ge4],位[wei4],名[ming2];  
烦	煩	fán	to feel vexed; to bother; to trouble; superfluous and confusing; edgy;  
反	反	fǎn	contrary; in reverse; inside out or upside down; to reverse; to return; to oppose; opposite; against; anti-; to rebel; to use analogy; instead; abbr. for 反切[fan3 qie4] phonetic system;  
反而	反而	fǎn ér	instead; on the contrary; contrary (to expectations);  
反映	反映	fǎn yìng	to mirror; to reflect; mirror image; reflection; (fig.) to report; to make known; to render;  
方	方	Fāng, fāng	surname Fang;  square; power or involution (mathematics); upright; honest; fair and square; direction; side; party (to a contract, dispute etc); place; method; prescription (medicine); just when; only or just; classifier for square things; abbr. for square or cubic meter;  
方案	方案	fāng àn	plan; program (for action etc); proposal; proposed bill; CL:個|个[ge4],套[tao4];  
方针	方針	fāng zhēn	policy; guidelines; CL:個|个[ge4];  
放松	放鬆	fàng sōng	to loosen; to relax;  
非	非	Fēi, fēi	abbr. for 非洲[Fei1 zhou1], Africa;  to not be; not; wrong; incorrect; non-; un-; in-; to reproach or blame; (colloquial) to insist on; simply must;  
肥	肥	féi	fat; fertile; loose-fitting or large; to fertilize; to become rich by illegal means; fertilizer; manure;  
分布	分布	fēn bù	to scatter; to distribute; to be distributed (over an area etc); (statistical, geographic) distribution;  
分散	分散	fēn sàn	to scatter; to disperse; to distribute;  
分手	分手	fēn shoǔ	to part company; to split up; to break up;  
分为	分為	fēn wéi	to divide sth into (parts); to subdivide;  
…分之…	…分之…	…fēnzhī…	... is divided into ...
纷纷	紛紛	fēn fēn	one after another; in succession; one by one; continuously; diverse; in profusion; numerous and confused; pell-mell;  
奋斗	奮鬥	fèn doù	to strive; to struggle;  
风格	風格	fēng gé	style;  
风景	風景	fēng jǐng	scenery; landscape; CL:個|个[ge4];  
风俗	風俗	fēng sú	social custom; CL:個|个[ge4];  
封闭	封閉	fēng bì	to seal; to close; to confine; to seal off; to close down; sealed; confined; closed; unreceptive;  
否则	否則	foǔ zé	if not; otherwise; else; or else;  
夫妇	夫婦	fū fù	a (married) couple; husband and wife; CL:對|对[dui4];  
夫妻	夫妻	fū qī	husband and wife; married couple;  
夫人	夫人	fū ren	lady; madam; Mrs.; CL:位[wei4];  
符号	符號	fú hào	symbol; mark; sign;  
符合	符閤	fú hé	in keeping with; in accordance with; tallying with; in line with; to agree with; to accord with; to conform to; to correspond with; to manage; to handle;  
付出	付齣	fù chū	to pay; to invest (energy or time in a friendship etc);  
负担	負擔	fù dān	burden; to bear a burden;  
附近	附近	fù jìn	(in the) vicinity; nearby; neighboring; next to;  
复制	復製	fù zhì	to duplicate; to make a copy of; to copy; to reproduce; to clone;  
改善	改善	gǎi shàn	to make better; to improve; CL:個|个[ge4];  
改正	改正	gǎi zhèng	to correct; to amend; to put right; correction; CL:個|个[ge4];  
盖	蓋	Gě, gài	surname Ge;  lid; top; cover; canopy; to cover; to conceal; to build;  
概括	概括	gài kuò	to summarize; to generalize; briefly; CL:個|个[ge4];  
感兴趣	感興趣	gǎn xìng qù	to be interested;  
高潮	高潮	gāo cháo	high tide; high water; upsurge; climax; orgasm; chorus (part of a song);  
高价	高價	gāo jià	high price;  
高尚	高尚	gāo shàng	noble; lofty; refined; exquisite;  
高铁	高鐵	gāo tiě	high speed rail;  
格外	格外	gé wài	especially; particularly;  
隔	隔	gé	to separate; to partition; to stand or lie between; at a distance from; after or at an interval of;  
隔开	隔開	gé kāi	to separate;  
个别	個彆	gè bié	individual; specific; respective; just one or two;  
个体	個體	gè tǐ	individual;  
各个	各個	gè gè	every; various; separately, one by one;  
根	根	gēn	root; basis; classifier for long slender objects, e.g. cigarettes, guitar strings; CL:條|条[tiao2]; radical (chemistry);  
根据	根據	gēn jù	according to; based on; basis; foundation; CL:個|个[ge4];  
工程	工程	gōng chéng	engineering; an engineering project; project; undertaking; CL:個|个[ge4],項|项[xiang4];  
公元	公元	gōng yuán	CE (Common Era); Christian Era; AD (Anno Domini);  
供应	供應	gōng yìng	to supply; to provide; to offer;  
共	共	gòng	common; general; to share; together; total; altogether; abbr. for 共產黨|共产党[Gong4 chan3 dang3], Communist party;  
构成	構成	goù chéng	to constitute; to form; to compose; to make up; to configure (computing);  
构造	構造	goù zào	structure; composition; tectonic (geology); CL:個|个[ge4];  
购买	購買	goù mǎi	to purchase; to buy;  
购物	購物	goù wù	shopping;  
骨头	骨頭	gǔ tou	bone; CL:根[gen1],塊|块[kuai4]; moral character; bitterness;  
固定	固定	gù dìng	to fix; to fasten; to set rigidly in place; fixed; set; regular;  
瓜	瓜	guā	melon; gourd; squash;  
怪	怪	guài, guài	variant of 怪[guai4];  
关	關	Guān, guān	surname Guan;  mountain pass; to close; to shut; to turn off; to concern; to involve;  
关闭	關閉	guān bì	to close; to shut;  
关于	關於	guān yú	pertaining to; concerning; with regard to; about; a matter of;  
官	官	Guān, guān	surname Guan;  government official; governmental; official; public; organ of the body; CL:個|个[ge4];  
官方	官方	guān fāng	government; official (approved or issued by an authority);  
光临	光臨	guāng lín	(formal) to honor with one's presence; to attend;  
光盘	光盤	guāng pán	compact disc; CD or DVD; CD ROM; CL:片[pian4],張|张[zhang1];  
逛	逛	guàng	to stroll; to visit;  
归	歸	Guī, guī	surname Gui;  to return; to go back to; to give back to; (of a responsibility) to be taken care of by; to belong to; to gather together; (used between two identical verbs) despite; to marry (of a woman) (old); division on the abacus with a one-digit divisor;  
规律	規律	guī lǜ	rule (e.g. of science); law of behavior; regular pattern; rhythm; discipline;  
规模	規模	guī mó	scale; scope; extent; CL:個|个[ge4];  
规则	規則	guī zé	rule; regulation; rules and regulations;  
果实	果實	guǒ shí	fruit (produced by a plant); (fig.) fruits (of success etc); results; gains;  
过分	過分	guò fèn	excessive; undue; overly;  
海水	海水	hǎi shuǐ	seawater;  
海鲜	海鮮	hǎi xiān	seafood;  
含	含	hán	to keep; to contain; to suck (keep in your mouth without chewing);  
含量	含量	hán liàng	content; quantity contained;  
含义	含義	hán yì	meaning (implicit in a phrase); implied meaning; hidden meaning; hint; connotation;  
含有	含有	hán yoǔ	to contain; including;  
寒假	寒假	hán jià	winter vacation;  
寒冷	寒冷	hán lěng	cold (climate); frigid; very cold;  
行业	行業	háng yè	industry; business;  
航班	航班	háng bān	scheduled flight; flight number; plane; scheduled sailing; sailing number; passenger ship;  
航空	航空	háng kōng	aviation;  
毫米	毫米	háo mǐ	millimeter;  
毫升	毫升	háo shēng	milliliter;  
好友	好友	hǎo yoǔ	close friend; pal; (social networking website) friend; CL:個|个[ge4];  
号码	號碼	hào mǎ	number; CL:堆[dui1],個|个[ge4];  
好	好	hǎo, hào	good; well; proper; good to; easy to; very; so; (suffix indicating completion or readiness); (of two people) close; on intimate terms;  to be fond of; to have a tendency to; to be prone to;  
合同	閤同	hé tong	(business) contract; CL:個|个[ge4];  
黑暗	黑暗	hēi àn	dark; darkly; darkness;  
红包	紅包	hóng bāo	money wrapped in red as a gift; bonus payment; kickback; bribe;  
后头	後頭	hoù tou	behind; in the back; the rear side; later; in future;  
厚	厚	hoù	thick; deep or profound; kind; generous; rich or strong in flavor; to favor; to stress;  
呼吸	呼吸	hū xī	to breathe;  
忽视	忽視	hū shì	to neglect; to ignore;  
户	戶	hù	a household; door; family;  
护士	護士	hù shi	nurse; CL:個|个[ge4];  
花	花	Huā, huā, huā, huā	surname Hua;  variant of 花[hua1]; flower; blossom; also pr. [wei3];  
划	劃	huá, huá, huà	to cut; to slash; to scratch (cut into the surface of sth); to strike (a match);  to delimit; to transfer; to assign; to plan; to draw (a line); stroke of a Chinese character;  
划	劃	huá, huá, huà	to cut; to slash; to scratch (cut into the surface of sth); to strike (a match);  to delimit; to transfer; to assign; to plan; to draw (a line); stroke of a Chinese character;  
怀念	懷念	huái niàn	to cherish the memory of; to think of; reminisce;  
怀疑	懷疑	huái yí	to doubt (sth); to be skeptical of; to have one's doubts; to harbor suspicions; to suspect that;  
缓解	緩解	huǎn jiě	to bring relief; to alleviate (a crisis); to dull (a pain);  
黄瓜	黃瓜	huáng guā	cucumber; CL:條|条[tiao2];  
黄金	黃金	huáng jīn	gold; golden (opportunity); prime (time);  
回复	迴復	huí fù	to reply; to recover; to return (to a previous condition); Re: in reply to (email);  
汇	匯	huì, huì, huì	variant of 匯|汇[hui4];  
汇报	匯報	huì bào, huì bào	to report; to give an account of; report;  
汇率	匯率	huì lǜ	exchange rate;  
婚礼	婚禮	hūn lǐ	wedding ceremony; wedding; CL:場|场[chang3];  
火	火	Huǒ, huǒ	surname Huo;  fire; urgent; ammunition; fiery or flaming; internal heat (Chinese medicine); hot (popular); classifier for military units (old);  
伙	夥	huǒ, huǒ	companion; partner; group; classifier for groups of people; to combine; together;  
伙伴	夥伴	huǒ bàn	partner; companion; comrade;  
或许	或許	huò xǔ	perhaps; maybe;  
货	貨	huò	goods; money; commodity; CL:個|个[ge4];  
获	獲	huò, huò	to reap; to harvest;  
获得	獲得	huò dé	to obtain; to receive; to get;  
获奖	獲奬	huò jiǎng	to win an award;  
获取	獲取	huò qǔ	to gain; to get; to acquire;  
几乎	幾乎	jī hū	almost; nearly; practically;  
机构	機構	jī goù	mechanism; structure; organization; agency; institution; CL:所[suo3];  
机遇	機遇	jī yù	opportunity; favorable circumstance; stroke of luck;  
积累	積纍	jī lěi	to accumulate; accumulation; cumulative; cumulatively;  
激动	激動	jī dòng	to move emotionally; to stir up (emotions); to excite;  
激烈	激烈	jī liè	intense; acute; fierce;  
及格	及格	jí gé	to pass an exam or a test; to meet a minimum standard;  
极	極	jí	extremely; pole (geography, physics); utmost; top;  
极其	極其	jí qí	extremely;  
即将	即將	jí jiāng	on the eve of; to be about to; to be on the verge of;  
急忙	急忙	jí máng	hastily;  
集合	集閤	jí hé	to gather; to assemble; set (mathematics);  
记载	記載	jì zǎi	to write down; to record; written account;  
纪律	紀律	jì lǜ	discipline;  
技巧	技巧	jì qiǎo	skill; technique;  
系	係	xì, xì, jì, xì	to connect; to arrest; to worry;  to tie; to fasten; to button up;  
季	季	Jì, jì	surname Ji;  season; the last month of a season; fourth or youngest amongst brothers; classifier for seasonal crop yields;  
季度	季度	jì dù	quarter of a year; season (sports);  
季节	季節	jì jié	time; season; period; CL:個|个[ge4];  
既	既	jì	already; since; both... (and...);  
既然	既然	jì rán	since; as; this being the case;  
寄	寄	jì	to send; to mail; to entrust; to depend on; to attach oneself to; to live (in a house); to lodge; foster (son etc);  
加班	加班	jiā bān	to work overtime;  
加入	加入	jiā rù	to become a member; to join; to mix into; to participate in; to add in;  
加油站	加油站	jiā yoú zhàn	gas station;  
家务	傢務	jiā wù	household duties; housework;  
假如	假如	jiǎ rú	if;  
坚固	堅固	jiān gù	firm; firmly; hard; stable;  
检测	檢測	jiǎn cè	to detect; to test; detection; sensing;  
减	減	jiǎn	to lower; to decrease; to reduce; to subtract; to diminish;  
减肥	減肥	jiǎn féi	to lose weight;  
减少	減少	jiǎn shǎo	to lessen; to decrease; to reduce; to lower;  
简历	簡曆	jiǎn lì	curriculum vitae (CV); résumé; biographical notes;  
健身	健身	jiàn shēn	to exercise; to keep fit; to work out; physical exercise;  
渐渐	漸漸	jiàn jiàn	gradually;  
江	江	Jiāng, jiāng	surname Jiang;  river; CL:條|条[tiao2],道[dao4];  
讲究	講究	jiǎng jiu	to pay particular attention to; carefully selected for quality; tastefully chosen;  
讲座	講座	jiǎng zuò	a course of lectures; CL:個|个[ge4];  
奖	奬	jiǎng	prize; award; encouragement; CL:個|个[ge4];  
奖金	奬金	jiǎng jīn	premium; award money; bonus;  
奖学金	奬學金	jiǎng xué jīn	scholarship; CL:個|个[ge4];  
降	降	jiàng, xiáng	to drop; to fall; to come down; to descend;  to surrender; to capitulate; to subdue; to tame;  
降低	降低	jiàng dī	to reduce; to lower; to bring down;  
降价	降價	jiàng jià	to cut the price; to drive down the price; to get cheaper;  
降落	降落	jiàng luò	to descend; to land;  
降温	降溫	jiàng wēn	to become cooler; to lower the temperature; cooling; (of interest, activity etc) to decline;  
交换	交換	jiāo huàn	to exchange; to swap; to switch (telecom); commutative (math); to commute;  
交际	交際	jiāo jì	communication; social intercourse;  
教授	教授	jiào shoù	professor; to instruct; to lecture on; CL:個|个[ge4],位[wei4];  
教训	教訓	jiào xun	lesson; moral; to chide sb; to lecture sb;  
阶段	階段	jiē duàn	stage; section; phase; period; CL:個|个[ge4];  
街道	街道	jiē dào	street; CL:條|条[tiao2]; subdistrict; residential district;  
节省	節省	jié shěng	saving; to save; to use sparingly; to cut down on;  
结	結	jiē, jié	(of a plant) to produce (fruit or seeds); Taiwan pr. [jie2];  knot; sturdy; bond; to tie; to bind; to check out (of a hotel);  
结构	結構	jié goù	structure; composition; makeup; architecture; CL:座[zuo4],個|个[ge4];  
结论	結論	jié lùn	conclusion; verdict; CL:個|个[ge4]; to conclude; to reach a verdict;  
姐妹	姐妹	jiě mèi	sisters; siblings; sister (school, city etc);  
解释	解釋	jiě shì	explanation; to explain; to interpret; to resolve; CL:個|个[ge4];  
尽快	盡快	jǐn kuài, jìn kuài, jǐn kuài	as quickly as possible; as soon as possible; with all speed;  see 盡快|尽快[jin3 kuai4];  
紧密	緊密	jǐn mì	inseparably close;  
尽力	盡力	jìn lì	to strive one's hardest; to spare no effort;  
进口	進口	jìn koǔ	to import; imported; entrance; inlet (for the intake of air, water etc);  
近代	近代	jìn dài	the not-very-distant past; modern times, excluding recent decades; (in the context of Chinese history) the period from the Opium Wars until the May 4th Movement (mid-19th century to 1919); capitalist times (pre-1949);  
禁止	禁止	jìn zhǐ	to prohibit; to forbid; to ban;  
经典	經典	jīng diǎn	the classics; scriptures; classical; classic (example, case etc); typical;  
精力	精力	jīng lì	energy;  
竟然	竟然	jìng rán	unexpectedly; to one's surprise; in spite of everything; in that crazy way; actually; to go as far as to;  
镜头	鏡頭	jìng toú	camera lens; camera shot (in a movie etc); scene;  
镜子	鏡子	jìng zi	mirror; CL:面[mian4],個|个[ge4];  
究竟	究竟	jiū jìng	to go to the bottom of a matter; after all; when all is said and done; (in an interrogative sentence) finally; outcome; result;  
酒吧	酒吧	jiǔ bā	bar; pub; saloon; CL:家[jia1];  
居民	居民	jū mín	resident; inhabitant;  
居住	居住	jū zhù	to reside; to dwell; to live in a place; resident in;  
局	局	jú, jú	office; situation; classifier for games: match, set, round etc;  
巨大	巨大	jù dà	huge; immense; very large; tremendous; gigantic; enormous;  
具备	具備	jù bèi	to possess; to have; equipped with; able to fulfill (conditions or requirements);  
距离	距離	jù lí	distance; CL:個|个[ge4]; to be apart from;  
聚	聚	jù	to congregate; to assemble; to mass; to gather together; to amass; to polymerize;  
聚会	聚會	jù huì	party; gathering; to meet; to get together;  
卷	捲	juǎn, juàn, juǎn	to roll (up); to sweep up; to carry on; roll;  scroll; book; volume; chapter; examination paper; classifier for books, paintings: volume, scroll;  
卷	捲	juǎn, juàn, juǎn	to roll (up); to sweep up; to carry on; roll;  scroll; book; volume; chapter; examination paper; classifier for books, paintings: volume, scroll;  
角色	角色	jué sè	role; character in a novel; persona; also pr. [jiao3 se4];  
开花	開花	kāi huā	to bloom; to blossom; to flower; fig. to burst open; to feel happy or elated; new development grows out;  
开水	開水	kāi shuǐ	boiled water; boiling water;  
看不起	看不起	kàn bu qǐ	to look down upon; to despise;  
看来	看來	kàn lai	apparently; it seems that;  
看望	看望	kàn wàng	to visit; to pay a call to;  
考察	考察	kǎo chá	to inspect; to observe and study; on-the-spot investigation;  
考虑	考慮	kǎo lǜ	to think over; to consider; consideration;  
棵	棵	kē	classifier for trees, cabbages, plants etc;  
可见	可見	kě jiàn	it can clearly be seen (that this is the case); it is (thus) clear; clear; visible;  
空间	空間	kōng jiān	empty space; room; outer space; space (physics, math.); (fig.) scope; leeway;  
空	空	kōng, kòng	empty; air; sky; in vain;  to empty; vacant; unoccupied; space; leisure; free time;  
口袋	口袋	koǔ dài	pocket; bag; sack; CL:個|个[ge4];  
口语	口語	koǔ yǔ	colloquial speech; spoken language; vernacular language; slander; gossip; CL:門|门[men2];  
苦	苦	kǔ	bitter; hardship; pain; to suffer; to bring suffering to; painstakingly;  
会计	會計	kuài jì	accountant; accountancy; accounting;  
快递	快遞	kuài dì	express delivery;  
宽	寬	Kuān, kuān	surname Kuan;  lenient; wide; broad;  
宽广	寬廣	kuān guǎng	wide; broad; extensive; vast;  
矿泉水	礦泉水	kuàng quán shuǐ	mineral spring water; CL:瓶[ping2],杯[bei1];  
扩大	擴大	kuò dà	to expand; to enlarge; to broaden one's scope;  
扩展	擴展	kuò zhǎn	to extend; to expand; extension; expansion;  
括号	括號	kuò hào	parentheses; brackets;  
垃圾	垃圾	lā jī	trash; refuse; garbage; (coll.) of poor quality; Taiwan pr. [le4 se4];  
拉开	拉開	lā kāi	to pull open; to pull apart; to space out; to increase;  
辣	辣	là, là	hot (spicy); pungent;  
来不及	來不及	lái bu jí	there's not enough time (to do sth); it's too late (to do sth);  
来得及	來得及	lái de jí	there's still time; able to do sth in time;  
来源	來源	lái yuán	source (of information etc); origin;  
老公	老公	lǎo gōng, lǎo gong	(coll.) husband;  (coll.) eunuch; see also 老公[lao3 gong1];  
老家	老傢	lǎo jiā	native place; place of origin; home state or region;  
老婆	老婆	lǎo pó	(coll.) wife;  
老实	老實	lǎo shi	honest; sincere; well-behaved; open and guileless; naive;  
乐趣	樂趣	lè qù	delight; pleasure; joy;  
泪	淚	lèi	tears;  
泪水	淚水	lèi shuǐ	teardrop; tears;  
类型	類型	lèi xíng	type; category; genre; form; style;  
冷静	冷靜	lěng jìng	calm; cool-headed;  
厘米	厘米	lí mǐ	centimeter;  
离不开	離不開	lí bu kāi	inseparable; inevitably linked to;  
力气	力氣	lì qi	strength; CL:把[ba3];  
历史	曆史	lì shǐ	history; CL:門|门[men2],段[duan4];  
立即	立即	lì jí	immediately;  
利息	利息	lì xī	interest (on a loan); CL:筆|笔[bi3];  
利益	利益	lì yì	benefit; (in sb's) interest; CL:個|个[ge4];  
俩	倆	liǎ	two (colloquial equivalent of 兩個|两个); both; some;  
良好	良好	liáng hǎo	good; favorable; well; fine;  
量	量	liáng, liàng	to measure;  capacity; quantity; amount; to estimate; abbr. for 量詞|量词[liang4 ci2], classifier (in Chinese grammar); measure word;  
粮食	糧食	liáng shi	foodstuff; cereals; CL:種|种[zhong3];  
两边	兩邊	liǎng bian	either side; both sides;  
疗养	療養	liáo yǎng	to get well; to heal; to recuperate; to convalesce; convalescence; to nurse;  
了不起	瞭不起	liǎo bu qǐ	amazing; terrific; extraordinary;  
了解	瞭解	liǎo jiě, liǎo jiě	to understand; to realize; to find out;  
列	列	liè	to arrange; to line up; row; file; series; column;  
列车	列車	liè chē	(railway) train;  
列入	列入	liè rù	to include on a list;  
列为	列為	liè wéi	to be classified as;  
临时	臨時	lín shí	as the time draws near; at the last moment; temporary; interim; ad hoc;  
零食	零食	líng shí	between-meal nibbles; snacks;  
流传	流傳	liú chuán	to spread; to circulate; to hand down;  
楼梯	樓梯	loú tī	stair; staircase; CL:個|个[ge4];  
陆地	陸地	lù dì	dry land (as opposed to the sea);  
陆续	陸續	lù xù	in turn; successively; one after the other; bit by bit;  
录取	錄取	lù qǔ	to recruit; to enroll;  
律师	律師	lǜ shī	lawyer;  
轮	輪	lún	wheel; disk; ring; steamship; to take turns; to rotate; by turn; classifier for big round objects: disk, or recurring events: round, turn;  
轮船	輪船	lún chuán	steamship; steamer; ocean liner; ship; CL:艘[sou1];  
轮椅	輪椅	lún yǐ	wheelchair;  
轮子	輪子	lún zi	wheel; CL:個|个[ge4];  
论文	論文	lùn wén	paper; treatise; thesis; CL:篇[pian1]; to discuss a paper or thesis (old);  
落	落	là, lào, luò	to leave out; to be missing; to leave behind or forget to bring; to lag or fall behind;  see 落枕[lao4 zhen3] and 落炕[lao4 kang4];  to fall or drop; (of the sun) to set; (of a tide) to go out; to lower; to decline or sink; to lag or fall behind; to fall onto; to rest with; to get or receive; to write down; whereabouts; settlement;  
毛巾	毛巾	máo jīn	towel; CL:條|条[tiao2];  
毛衣	毛衣	máo yī	(wool) sweater; CL:件[jian4];  
帽子	帽子	mào zi	hat; cap; (fig.) label; bad name; CL:頂|顶[ding3];  
没错	沒錯	méi cuò	that's right; sure!; rest assured!; that's good; can't go wrong;  
没法儿	沒法兒	méifǎér	Can't
没想到	沒想到	méi xiǎng dào	didn't expect;  
美金	美金	Měi jīn	US dollar; USD;  
美女	美女	měi nǚ	beautiful woman;  
梦	夢	mèng	dream; CL:場|场[chang2],個|个[ge4];  
梦见	夢見	mèng jiàn	to dream about (sth or sb); to see in a dream;  
梦想	夢想	mèng xiǎng	(fig.) to dream of; dream;  
秘密	秘密	mì mì	secret; CL:個|个[ge4];  
秘书	秘書	mì shū	secretary;  
密	密	Mì, mì	surname Mi; name of an ancient state;  secret; confidential; close; thick; dense;  
密码	密碼	mì mǎ	code; secret code; password; pin number;  
密切	密切	mì qiè	close; familiar; intimate; closely (related); to foster close ties; to pay close attention;  
免费	免費	miǎn fèi	free (of charge);  
面临	麵臨	miàn lín	to face sth; to be confronted with;  
面试	麵試	miàn shì	to be interviewed (as a candidate); interview;  
描述	描述	miáo shù	to describe; description;  
描写	描寫	miáo xiě	to describe; to depict; to portray; description;  
名牌儿	名牌兒	míngpáiér	Famous brand
名片	名片	míng piàn	(business) card;  
名人	名人	míng rén	personage; celebrity;  
摸	摸	mō, mó	to feel with the hand; to touch; to stroke; to grope; to steal; to abstract;  variant of 摹[mo2];  
模特儿	模特兒	mo2 te4 r5	(fashion) model (loanword);  
模型	模型	mó xíng	model; mold; matrix; pattern;  
末	末	mò	tip; end; final stage; latter part; inessential detail; powder; dust; opera role of old man;  
默默	默默	mò mò	in silence; not speaking;  
哪怕	哪怕	nǎ pà	even; even if; even though; no matter how;  
哪	哪	nǎ, na, něi	how; which;  (particle equivalent to 啊 after noun ending in -n);  which? (interrogative, followed by classifier or numeral-classifier);  
男女	男女	nán nǚ	male-female; male and female;  
男士	男士	nán shì	man; gentleman;  
难免	難免	nán miǎn	hard to avoid; difficult to escape from; will inevitably;  
脑袋	腦袋	nǎo dài	head; skull; brains; mental capability; CL:顆|颗[ke1],個|个[ge4];  
闹	鬧	nào, nào	noisy; cacophonous; to make noise; to disturb; to vent (feelings); to fall ill; to have an attack (of sickness); to go in (for some activity); to joke;  
闹钟	鬧鍾	nào zhōng	alarm clock;  
内部	內部	nèi bù	interior; inside (part, section); internal;  
内科	內科	nèi kē	internal medicine; general medicine;  
能干	能乾	néng gàn	capable; competent;  
宁静	寜靜	níng jìng	tranquil; tranquility; serenity;  
浓	濃	nóng	concentrated; dense; strong (smell etc);  
女士	女士	nǚ shì	lady; madam; CL:個|个[ge4],位[wei4]; Miss; Ms;  
暖气	暖氣	nuǎn qì	central heating; heater; warm air;  
拍照	拍照	pāi zhào	to take a picture;  
排列	排列	pái liè	array; arrangement; permutation (i.e. ordered choice of n elements out of m);  
牌	牌	pái	mahjong tile; playing card; game pieces; signboard; plate; tablet; medal; CL:片[pian4],個|个[ge4],塊|块[kuai4];  
盘	盤	pán	plate; dish; tray; board; hard drive (computing); to build; to coil; to check; to examine; to transfer (property); to make over; classifier for food: dish, helping; to coil; classifier for coils of wire; classifier for games of chess;  
盘子	盤子	pán zi	tray; plate; dish; CL:個|个[ge4];  
胖子	胖子	pàng zi	fat person; fatty;  
培训	培訓	péi xùn	to cultivate; to train; to groom; training;  
培训班	培訓班	péi xùn bān	training class;  
培养	培養	péi yǎng	to cultivate; to breed; to foster; to nurture; to educate; to groom (for a position); education; fostering; culture (biology);  
培育	培育	péi yù	to train; to breed;  
批	批	pī	to ascertain; to act on; to criticize; to pass on; classifier for batches, lots, military flights; tier (for the ranking of universities and colleges);  
批	批	pī	to ascertain; to act on; to criticize; to pass on; classifier for batches, lots, military flights; tier (for the ranking of universities and colleges);  
片面	片麵	piàn miàn	unilateral; one-sided;  
品质	品質	pǐn zhì	character; intrinsic quality (of a person); quality (of a product or service, or as in 'quality of life', 'air quality' etc);  
平方	平方	píng fāng	square (as in square foot, square mile, square root);  
平静	平靜	píng jìng	tranquil; undisturbed; serene;  
平均	平均	píng jūn	average; on average; evenly; in equal proportions;  
平稳	平穩	píng wěn	smooth; steady;  
迫切	迫切	pò qiè	urgent; pressing;  
破产	破産	pò chǎn	to go bankrupt; to become impoverished; bankruptcy;  
妻子	妻子	qī zǐ, qī zi	wife and children;  wife; CL:個|个[ge4];  
期待	期待	qī dài	to look forward to; to await; expectation;  
期间	期間	qī jiān	period of time; time; time period; period; CL:個|个[ge4];  
期末	期末	qī mò	end of term;  
期限	期限	qī xiàn	time limit; deadline; allotted time;  
期中	期中	qī zhōng	interim; midterm;  
其余	其餘	qí yú	the rest; the others; remaining; remainder; apart from them;  
企业	企業	qǐ yè	company; firm; enterprise; corporation; CL:家[jia1];  
气球	氣球	qì qiú	balloon;  
汽水	汽水	qì shuǐ	soda; pop;  
汽油	汽油	qì yoú	gasoline;  
器官	器官	qì guān	organ (part of body tissue); apparatus;  
前头	前頭	qián tou	in front; at the head; ahead; above;  
前途	前途	qián tú	prospects; future outlook; journey;  
浅	淺	jiān, qiǎn	sound of moving water;  shallow; light (color);  
巧克力	巧剋力	qiǎo kè lì	chocolate (loanword); CL:塊|块[kuai4];  
切	切	qiē, qiè	to cut; to slice; tangent (math);  definitely; absolutely (not); (scoffing or dismissive interjection) Yeah, right.; Tut!; to grind; close to; eager; to correspond to; see also 反切[fan3 qie4];  
亲爱	親愛	qīn ài	dear; beloved; darling;  
亲密	親密	qīn mì	intimate; close;  
青春	青春	qīng chūn	youth; youthfulness;  
轻松	輕鬆	qīng sōng	light; gentle; relaxed; effortless; uncomplicated; to relax; to take things less seriously;  
轻易	輕易	qīng yì	easily; lightly; rashly;  
清醒	清醒	qīng xǐng	clear-headed; sober; awake;  
情景	情景	qíng jǐng	scene; spectacle; circumstances; situation;  
穷	窮	qióng	poor; destitute; to use up; to exhaust; thoroughly; extremely; (coll.) persistently and pointlessly;  
穷人	窮人	qióng rén	poor people; the poor;  
秋季	鞦季	qiū jì	autumn; fall;  
趋势	趨勢	qū shì	trend; tendency;  
圈	圈	juān, juàn, quān	to confine; to lock up; to pen in;  pen (pig); a fold;  circle; ring; loop; classifier for loops, orbits, laps of race etc; CL:個|个[ge4]; to surround; to circle;  
权利	權利	quán lì	power; right; privilege;  
却	卻	què, què	but; yet; however; while; to go back; to decline; to retreat; nevertheless; even though;  
确认	確認	què rèn	to confirm; to verify; confirmation;  
然而	然而	rán ér	however; yet; but;  
燃料	燃料	rán liào	fuel;  
燃烧	燃燒	rán shāo	to ignite; to combust; to burn; combustion; flaming;  
热闹	熱鬧	rè nao	bustling with noise and excitement; lively;  
热心	熱心	rè xīn	enthusiasm; zeal; zealous; zest; enthusiastic; ardent; warmhearted;  
人家	人傢	rén jiā, rén jia	household; dwelling; family; sb else's house; household business; house of woman's husband-to-be; CL:戶|户[hu4],家[jia1];  other people; sb else; he, she or they; I, me (referring to oneself as 'one' or 'people');  
日记	日記	rì jì	diary; CL:則|则[ze2],本[ben3],篇[pian1];  
日历	日曆	rì lì	calendar; CL:張|张[zhang1],本[ben3];  
如今	如今	rú jīn	nowadays; now;  
弱	弱	ruò	weak; feeble; young; inferior; (following a decimal or fraction) slightly less than;  
伞	傘	sǎn, sǎn	damask silk; variant of 傘|伞[san3];  
散	散	sàn, sǎn, sàn	to scatter; to break up (a meeting etc); to disperse; to disseminate; to dispel; (coll.) to sack;  scattered; loose; to come loose; to fall apart; leisurely; powdered medicine;  
扫	掃	sǎo, sào	to sweep;  broom;  
色	色	sè, shǎi	color; CL:種|种[zhong3]; look; appearance; sex;  color; dice;  
色彩	色彩	sè cǎi	tint; coloring; coloration; (fig.) flavor; character;  
耕	耕	gēng, gēng	to plow; to till;  
晒	曬	shài, shài	(of the sun) to shine on; to bask in (the sunshine); to dry (clothes, grain etc) in the sun; (fig.) to expose and share (one's experiences and thoughts) on the Web (loanword from 'share'); (coll.) to give the cold shoulder to;  
闪	閃	Shǎn, shǎn	surname Shan;  to dodge; to duck out of the way; to beat it; shaken (by a fall); to sprain; to pull a muscle; lightning; spark; a flash; to flash (across one's mind); to leave behind; (Internet slang) (of a display of affection) 'dazzlingly' saccharine;  
闪电	閃電	shǎn diàn	lightning; CL:道[dao4];  
善良	善良	shàn liáng	good and honest; kindhearted;  
善于	善於	shàn yú	to be good at; to be adept at;  
伤害	傷害	shāng hài	to injure; to harm;  
商务	商務	shāng wù	commercial affairs; commercial; commerce; business;  
赏	賞	shǎng	to bestow (a reward); to give (to an inferior); to hand down; a reward (bestowed by a superior); to appreciate (beauty);  
上个月	上個月	shàng gè yuè	last month;  
上楼	上樓	shàng loú	to go upstairs;  
上门	上門	shàng mén	to drop in; to visit; to lock a door; (of a shop) to close; to go and live with one's wife's family, in effect becoming a member of her family;  
烧	燒	shāo	to burn; to cook; to stew; to bake; to roast; to heat; to boil (tea, water etc); fever; to run a temperature; (coll.) to let things go to one's head;  
设施	設施	shè shī	facilities; installation;  
设置	設置	shè zhì	to set up; to install;  
申请	申請	shēn qǐng	to apply for sth; application (form etc); CL:份[fen4];  
身材	身材	shēn cái	stature; build (height and weight); figure;  
身份	身份	shēn fèn	identity; status; capacity; dignity; position; rank;  
身高	身高	shēn gāo	(a person's) height;  
深厚	深厚	shēn hoù	deep; profound;  
神话	神話	shén huà	legend; fairy tale; myth; mythology;  
神秘	神秘	shén mì	mysterious; mystery;  
甚至	甚至	shèn zhì	even; so much so that;  
失败	失敗	shī bài	to be defeated; to lose; to fail (e.g. experiments); failure; defeat; CL:次[ci4];  
失望	失望	shī wàng	disappointed; to lose hope; to despair;  
失业	失業	shī yè	unemployment; to lose one's job;  
诗	詩	Shī, shī	abbr. for Shijing 詩經|诗经[Shi1 jing1], the Book of Songs;  poem; CL:首[shou3]; poetry; verse;  
诗人	詩人	shī rén	bard; poet;  
湿	濕	shī, shī	moist; wet;  
实施	實施	shí shī	to implement; to carry out;  
实用	實用	shí yòng	practical; functional; pragmatic; applied (science);  
食堂	食堂	shí táng	dining hall; CL:個|个[ge4],間|间[jian1];  
使劲	使勁	shǐ jìn	to exert all one's strength;  
士兵	士兵	shì bīng	soldier; CL:個|个[ge4];  
市区	市區	shì qū	urban district; downtown; city center;  
似的	似的	shì de	seems as if; rather like; Taiwan pr. [si4 de5];  
事物	事物	shì wù	thing; object; CL:個|个[ge4];  
事先	事先	shì xiān	in advance; before the event; beforehand; prior;  
试卷	試捲	shì juàn	examination paper; test paper; CL:份[fen4],張|张[zhang1];  
是否	是否	shì foǔ	whether (or not); if; is or isn't;  
收回	收迴	shoū huí	to regain; to retake; to take back; to withdraw; to revoke;  
收获	收獲	shoū huò, shoū huò	to harvest; to reap; to gain; crop; harvest; profit; gain; bonus; reward;  
收益	收益	shoū yì	earnings; profit;  
手工	手工	shoǔ gōng	handwork; manual;  
手里	手裏	shoǔ lǐ	in hand; (a situation is) in sb's hands;  
手术	手術	shoǔ shù	(surgical) operation; surgery; CL:個|个[ge4];  
手套	手套	shoǔ tào	glove; mitten; CL:雙|双[shuang1],隻|只[zhi1];  
守	守	shoǔ	to guard; to defend; to keep watch; to abide by the law; to observe (rules or ritual); nearby; adjoining;  
首	首	shoǔ	head; chief; first (occasion, thing etc); classifier for poems, songs etc;  
受不了	受不瞭	shoù bù liǎo	unbearable; unable to endure; can't stand;  
售货员	售貨員	shoù huò yuán	salesperson; CL:個|个[ge4];  
叔叔	叔叔	shū shu	father's younger brother; uncle; Taiwan pr. [shu2 shu5]; CL:個|个[ge4];  
舒适	舒適	shū shì	cozy; snug;  
熟练	熟練	shú liàn	practiced; proficient; skilled; skillful;  
暑假	暑假	shǔ jià	summer vacation; CL:個|个[ge4];  
树林	樹林	Shù lín, shù lín	Shulin city in New Taipei City 新北市[Xin1 bei3 shi4], Taiwan;  woods; grove; forest;  
树叶	樹葉	shù yè	tree leaves;  
数据	數據	shù jù	data; numbers; digital;  
数码	數碼	shù mǎ	number; numerals; figures; digital; amount; numerical code;  
刷	刷	shuā, shuà	to brush; to paint; to daub; to paste up; to skip class (of students); to fire from a job;  to select;  
刷牙	刷牙	shuā yá	to brush one's teeth;  
刷子	刷子	shuā zi	brush; scrub; CL:把[ba3];  
帅	帥	Shuài, shuài	surname Shuai;  handsome; graceful; smart; commander in chief; (coll.) cool!; sweet!;  
帅哥	帥哥	shuài gē	handsome guy; lady-killer; handsome (form of address);  
率先	率先	shuài xiān	to take the lead; to show initiative;  
睡着	睡著	shuì zháo	to fall asleep;  
顺序	順序	shùn xù	sequence; order;  
说不定	說不定	shuō bu dìng	can't say for sure; maybe;  
说服	說服	shuō fú	to persuade; to convince; to talk sb over; Taiwan pr. [shui4 fu2];  
思考	思考	sī kǎo	to reflect on; to ponder over;  
似乎	似乎	sì hū	apparently; to seem; to appear; as if; seemingly;  
松	鬆	Sōng, sōng, sōng	surname Song;  loose; to loosen; to relax;  
松树	鬆樹	sōng shù	pine; pine tree; CL:棵[ke1];  
塑料	塑料	sù liào	plastics; CL:種|种[zhong3];  
塑料袋	塑料袋	sù liào dài	plastic bag;  
酸	酸	suān	sour; tart; sick at heart; grieved; sore; aching; pedantic; impractical; an acid;  
酸奶	酸奶	suān nǎi	yogurt;  
随手	隨手	suí shoǔ	conveniently; without extra trouble; while doing it; in passing;  
孙女	孫女	sūn nǚ	son's daughter; granddaughter;  
孙子	孫子	Sūn zǐ, sūn zi	Sun Tzu, also known as Sun Wu 孫武|孙武[Sun1 Wu3] (c. 500 BC, dates of birth and death uncertain), general, strategist and philosopher of the Spring and Autumn Period (700-475 BC), believed to be the author of the “Art of War” 孫子兵法|孙子兵法[Sun1 zi3 Bing1 fa3], one of the Seven Military Classics of ancient China 武經七書|武经七书[Wu3 jing1 Qi1 shu1];  grandson; son's son;  
缩短	縮短	suō duǎn	to curtail; to cut down;  
缩小	縮小	suō xiǎo	to reduce; to decrease; to shrink;  
台阶	颱階	tái jiē	steps; flight of steps; step (over obstacle); fig. way out of an embarrassing situation; bench (geology);  
台上	颱上	tái shàng	on stage;  
躺	躺	tǎng	to recline; to lie down;  
套餐	套餐	tào cān	set meal; product or service package (e.g. for a cell phone subscription);  
特价	特價	tè jià	special price;  
特殊	特殊	tè shū	special; particular; unusual; extraordinary;  
特征	特徵	tè zhēng	characteristic; diagnostic property; distinctive feature; trait;  
提供	提供	tí gōng	to offer; to supply; to provide; to furnish;  
提醒	提醒	tí xǐng	to remind; to call attention to; to warn of;  
体操	體操	tǐ cāo	gymnastic; gymnastics;  
体检	體檢	tǐ jiǎn	abbr. for 體格檢查|体格检查[ti3 ge2 jian3 cha2];  
体重	體重	tǐ zhòng	body weight;  
替	替	tì	to substitute for; to take the place of; to replace; for; on behalf of; to stand in for;  
替代	替代	tì dài	to substitute for; to replace; to supersede;  
天真	天真	tiān zhēn	naive; innocent; artless;  
填	填	tián	to fill or stuff; (of a form etc) to fill in;  
填空	填空	tián kòng	to fill a job vacancy; to fill in a blank (e.g. on questionnaire or exam paper);  
挑	挑	tiāo, tiǎo	to carry on a shoulder pole; to choose; to pick; to nitpick;  to raise; to dig up; to poke; to prick; to incite; to stir up;  
挑选	挑選	tiāo xuǎn	to choose; to select;  
调皮	調皮	tiáo pí	naughty; mischievous; unruly;  
挑	挑	tiāo, tiǎo	to carry on a shoulder pole; to choose; to pick; to nitpick;  to raise; to dig up; to poke; to prick; to incite; to stir up;  
挑战	挑戰	tiǎo zhàn	to challenge; challenge;  
贴	貼	tiē	to stick; to paste; to post (e.g. on a blog); to keep close to; to fit snugly; to subsidize; allowance (e.g. money for food or housing); sticker; classifier for sticking plaster: strip;  
停下	停下	tíng xià	to stop;  
挺	挺	tǐng	straight; erect; to stick out (a part of the body); to (physically) straighten up; to support; to withstand; outstanding; (coll.) quite; very; classifier for machine guns;  
通知书	通知書	tōngzhīshū	Notice
同情	同情	tóng qíng	to sympathize with; sympathy;  
童话	童話	tóng huà	children's fairy tales;  
童年	童年	tóng nián	childhood;  
统计	統計	tǒng jì	statistics; to count; to add up;  
统一	統一	tǒng yī	to unify; to unite; to integrate;  
痛快	痛快	tòng kuài	delighted; to one's heart's content; straightforward; also pr. [tong4 kuai5];  
投	投	toú	to cast; to send; to throw oneself (into the river etc); to seek refuge; to place oneself into the hands of;  
投入	投入	toú rù	to throw into; to put into; to throw oneself into; to participate in; to invest in; absorbed; engrossed;  
投诉	投訴	toú sù	complaint; to complain; to register a complaint (esp. as a customer);  
投资	投資	toú zī	investment; to invest;  
透	透	toù	to penetrate; to pass through; thoroughly; completely; transparent; to appear; to show;  
透明	透明	toù míng	transparent; open (non-secretive);  
图案	圖案	tú àn	design; pattern;  
途中	途中	tú zhōng	en route;  
土地	土地	tǔ dì, tǔ di	land; soil; territory; CL:片[pian4],塊|块[kuai4];  local god; genius loci;  
推迟	推遲	tuī chí	to postpone; to put off; to defer;  
推销	推銷	tuī xiāo	to market; to sell;  
脱	脫	tuō	to shed; to take off; to escape; to get away from;  
袜子	襪子	wà zi	socks; stockings; CL:隻|只[zhi1],對|对[dui4],雙|双[shuang1];  
外汇	外匯	wài huì	foreign (currency) exchange;  
外交官	外交官	wài jiāo guān	diplomat;  
外套	外套	wài tào	coat; jacket; CL:件[jian4];  
弯	彎	wān	to bend; bent; a bend; a turn (in the road etc); CL:道[dao4];  
晚点	晚點	wǎn diǎn	(of trains etc) late; delayed; behind schedule; light dinner;  
万一	萬一	wàn yī	just in case; if by any chance; contingency;  
王	王	Wáng, wáng, wàng	surname Wang;  king or monarch; best or strongest of its type; grand; great;  to rule; to reign over;  
网络	網絡	Wǎng luò, wǎng luò	Internet;  network (computing, telecommunications, transport etc);  
网址	網址	wǎng zhǐ	website; web address; URL;  
微笑	微笑	wēi xiào	smile; CL:個|个[ge4],絲|丝[si1]; to smile;  
微信	微信	Wēi xìn	Weixin or WeChat (mobile text and voice messaging service developed by Tencent 騰訊|腾讯[Teng2 xun4]);  
围巾	圍巾	wéi jīn	scarf; shawl; CL:條|条[tiao2];  
维持	維持	wéi chí	to keep; to maintain; to preserve;  
维护	維護	wéi hù	to defend; to safeguard; to protect; to uphold; to maintain;  
维修	維修	wéi xiū	maintenance (of equipment); to protect and maintain;  
尾巴	尾巴	wěi ba	tail; colloquial pr. [yi3 ba5];  
未必	未必	wèi bì	not necessarily; maybe not;  
未来	未來	wèi lái	future; tomorrow; CL:個|个[ge4]; approaching; coming; pending;  
位于	位於	wèi yú	to be located at; to be situated at; to lie;  
位置	位置	wèi zhi	position; place; seat; CL:個|个[ge4];  
味儿	味兒	wei4 r5	taste;  
喂	喂	wéi, wèi, wèi, wèi	hello (when answering the phone);  to feed;  
稳	穩	wěn	settled; steady; stable;  
稳定	穩定	wěn dìng	steady; stable; stability; to stabilize; to pacify;  
问候	問候	wèn hoù	to give one's respects; to send a greeting;  
无	無	wú	not to have; no; none; not; to lack; un-; -less;  
无法	無法	wú fǎ	unable; incapable;  
无聊	無聊	wú liáo	bored; boring; senseless;  
无论	無論	wú lùn	no matter what or how; regardless of whether...;  
无数	無數	wú shù	countless; numberless; innumerable;  
无所谓	無所謂	wú suǒ wèi	to be indifferent; not to matter; cannot be said to be;  
无限	無限	wú xiàn	unlimited; unbounded;  
五颜六色	五顔六色	wǔ yán liù sè	multi-colored; every color under the sun;  
误会	誤會	wù huì	to misunderstand; to mistake; misunderstanding; CL:個|个[ge4];  
西瓜	西瓜	xī guā	watermelon; CL:顆|颗[ke1],粒[li4],個|个[ge5];  
吸	吸	xī	to breathe; to suck in; to absorb; to inhale;  
吸管	吸管	xī guǎn	(drinking) straw; pipette; eyedropper; snorkel; CL:支[zhi1];  
吸收	吸收	xī shoū	to absorb; to assimilate; to ingest; to recruit;  
吸烟	吸煙	xī yān	to smoke;  
吸引	吸引	xī yǐn	to attract (interest, investment etc); CL:個|个[ge4];  
喜爱	喜愛	xǐ ài	to like; to love; to be fond of; favorite;  
系列	係列	xì liè	series; set;  
系统	係統	xì tǒng	system; CL:個|个[ge4];  
细	細	xì	thin or slender; finely particulate; thin and soft; fine; delicate; trifling; (of a sound) quiet; frugal;  
细节	細節	xì jié	details; particulars;  
细致	細緻	xì zhì	delicate; fine; careful; meticulous; painstaking;  
下个月	下個月	xià gè yuè	next month;  
下降	下降	xià jiàng	to decline; to drop; to fall; to go down; to decrease;  
下楼	下樓	xiàlóu	Go downstairs
下载	下載	xià zǎi	to download; also pr. [xia4 zai4];  
夏季	夏季	xià jì	summer;  
鲜	鮮	xiǎn, xiǎn, xiān, xiǎn, xiān, xiǎn	old variant of 鮮|鲜[xian3];  fish; old variant of 鮮|鲜[xian1];  
鲜花	鮮花	xiān huā	flower; fresh flowers; CL:朵[duo3];  
鲜明	鮮明	xiān míng	bright; clear-cut; distinct;  
咸	鹹	Xián, xián, xián	surname Xian;  salted; salty; stingy; miserly;  
显著	顯著	xiǎn zhù	outstanding; notable; remarkable; statistically significant;  
县	縣	xiàn	county;  
限制	限製	xiàn zhì	to restrict; to limit; to confine; restriction; limit; CL:個|个[ge4];  
相处	相處	xiāng chǔ	to be in contact (with sb); to associate; to interact; to get along (well, poorly);  
相反	相反	xiāng fǎn	opposite; contrary;  
箱	箱	xiāng	box; trunk; chest;  
箱子	箱子	xiāng zi	suitcase; chest; box; case; trunk; CL:隻|只[zhi1],個|个[ge4];  
想念	想念	xiǎng niàn	to miss; to remember with longing; to long to see again;  
想象	想象	xiǎng xiàng	to imagine; to fancy; CL:個|个[ge4];  
项	項	Xiàng, xiàng	surname Xiang;  back of neck; item; thing; term (in a mathematical formula); sum (of money); classifier for principles, items, clauses, tasks, research projects etc;  
项目	項目	xiàng mù	item; project; (sports) event; CL:個|个[ge4];  
相片	相片	xiàng piàn	image; photograph; CL:張|张[zhang1];  
消化	消化	xiāo huà	to digest; digestion; digestive;  
销售	銷售	xiāo shoù	to sell; to market; sales (representative, agreement etc);  
小吃	小吃	xiǎo chī	snack; refreshments; CL:家[jia1];  
小伙子	小夥子	xiǎo huǒ zi	young man; young guy; lad; youngster; CL:個|个[ge4];  
小型	小型	xiǎo xíng	small scale; small size;  
效率	效率	xiào lǜ	efficiency;  
些	些	xiē	some; few; several; measure word indicating a small amount or small number (greater than 1);  
心理	心理	xīn lǐ	mental; psychological;  
新郎	新郎	xīn láng	bridegroom; groom;  
新娘	新娘	xīn niáng	bride;  
新鲜	新鮮	xīn xiān	fresh (experience, food etc); freshness; novel; uncommon;  
新型	新型	xīn xíng	new type; new kind;  
兴奋	興奮	xīng fèn	excited; excitement;  
形容	形容	xíng róng	to describe; description; appearance; look;  
形势	形勢	xíng shì	circumstances; situation; terrain; CL:個|个[ge4];  
型	型	xíng	mold; type; style; model;  
型号	型號	xíng hào	model number;  
醒	醒	xǐng	to wake up; to be awake; to become aware; to sober up; to come to;  
兴趣	興趣	xìng qù	interest (desire to know about sth); interest (thing in which one is interested); hobby; CL:個|个[ge4];  
性质	性質	xìng zhì	nature; characteristic; CL:個|个[ge4];  
兄弟	兄弟	xiōng dì	brothers; younger brother; CL:個|个[ge4]; I, me (humble term used by men in public speech); brotherly; fraternal;  
胸部	胸部	xiōng bù	chest; bosom;  
修理	修理	xiū lǐ	to repair; to fix; to prune; to trim; (coll.) to sort sb out; to fix sb;  
选择	選擇	xuǎn zé	to select; to pick; choice; option; alternative;  
学分	學分	xué fēn	course credit;  
学年	學年	xué nián	academic year;  
学时	學時	xué shí	class hour; period;  
学术	學術	xué shù	learning; science; academic; CL:個|个[ge4];  
学问	學問	xué wèn	learning; knowledge; CL:個|个[ge4];  
寻找	尋找	xún zhǎo	to seek; to look for;  
迅速	迅速	xùn sù	rapid; speedy; fast;  
牙	牙	yá	tooth; ivory; CL:顆|颗[ke1];  
牙刷	牙刷	yá shuā	toothbrush; CL:把[ba3];  
亚运会	亞運會	Yà yùn huì	Asian Games;  
呀	呀	ya	(particle equivalent to 啊 after a vowel, expressing surprise or doubt);  
延长	延長	Yán cháng, yán cháng	Yanchang county in Yan'an 延安[Yan2 an1], Shaanxi;  to prolong; to extend; to delay;  
延期	延期	yán qī	to delay; to extend; to postpone; to defer;  
延续	延續	yán xù	to continue; to go on; to last;  
严	嚴	Yán, yán	surname Yan;  tight (closely sealed); stern; strict; rigorous; severe; father;  
严格	嚴格	yán gé	strict; stringent; tight; rigorous;  
严重	嚴重	yán zhòng	grave; serious; severe; critical;  
研究	研究	yán jiū	research; a study; CL:項|项[xiang4];  
研究生	研究生	yán jiū shēng	graduate student; postgraduate student; research student;  
研制	研製	yán zhì	to manufacture; to develop;  
盐	鹽	yán	salt; CL:粒[li4];  
眼镜	眼鏡	yǎn jìng	spectacles; eyeglasses; CL:副[fu4];  
眼泪	眼淚	yǎn lèi	tears; crying; CL:滴[di1];  
眼里	眼裏	yǎnlǐ	In the eyes
演讲	演講	yǎn jiǎng	lecture; to make a speech;  
阳台	陽颱	yáng tái, yáng tái	balcony; porch;  
养成	養成	yǎng chéng	to cultivate; to raise; to form (a habit); to acquire;  
腰	腰	yāo	waist; lower back; pocket; middle; loins;  
摇	搖	Yáo, yáo	surname Yao;  to shake; to rock; to row; to crank;  
药物	藥物	yào wù	medicaments; pharmaceuticals; medication; medicine; drug;  
要	要	yāo, yào	to demand; to request; to coerce;  important; vital; to want; to ask for; will; going to (as future auxiliary); may; must; (used in a comparison) must be; probably; if;  
业余	業餘	yè yú	in one's spare time; outside working hours; amateur (historian etc);  
叶子	葉子	yè zi	foliage; leaf; CL:片[pian4];  
医疗	醫療	yī liáo	medical treatment;  
医学	醫學	yī xué	medicine; medical science; study of medicine;  
依靠	依靠	yī kào	to rely on sth (for support etc); to depend on;  
依然	依然	yī rán	still; as before;  
一律	一律	yī lǜ	same; uniformly; all; without exception;  
一再	一再	yī zài	repeatedly;  
一致	一緻	yī zhì	unanimous; identical (views or opinions);  
移	移	yí	to move; to shift; to change; to alter; to remove;  
移动	移動	yí dòng	to move; movement; migration; mobile; portable;  
移民	移民	yí mín	to immigrate; to migrate; emigrant; immigrant;  
遗产	遺産	yí chǎn	heritage; legacy; inheritance; bequest; CL:筆|笔[bi3];  
遗传	遺傳	yí chuán	heredity; inheritance; to transmit;  
疑问	疑問	yí wèn	question; interrogation; doubt;  
以及	以及	yǐ jí	as well as; too; and;  
以内	以內	yǐ nèi	within; less than;  
一般来说	一般來說	yī bān lái shuō	generally speaking;  
义务	義務	yì wù	duty; obligation; CL:項|项[xiang4]; volunteer (work etc);  
议论	議論	yì lùn	to comment; to talk about; to discuss; discussion; CL:個|个[ge4];  
引	引	yǐn	to draw (e.g. a bow); to pull; to stretch sth; to extend; to lengthen; to involve or implicate in; to attract; to lead; to guide; to leave; to provide evidence or justification for; old unit of distance equal to 10 丈[zhang4], one-thirtieth of a km or 33.33 meters;  
引导	引導	yǐn dǎo	to guide; to lead (around); to conduct; to boot; introduction; primer;  
引进	引進	yǐn jìn	to recommend; to introduce (from outside);  
引起	引起	yǐn qǐ	to give rise to; to lead to; to cause; to arouse;  
应	應	Yìng, yīng, yìng	surname Ying;  to agree (to do sth); should; ought to; must; (legal) shall;  to answer; to respond; to comply with; to deal or cope with;  
英勇	英勇	yīng yǒng	heroic; gallant; valiant;  
营业	營業	yíng yè	to do business; to trade;  
赢得	贏得	yíng dé	to win; to gain;  
影子	影子	yǐng zi	shadow; reflection; (fig.) hint; indication; influence; CL:個|个[ge4];  
勇敢	勇敢	yǒng gǎn	brave; courageous;  
勇气	勇氣	yǒng qì	courage; valor;  
用途	用途	yòng tú	use; application;  
优良	優良	yoū liáng	fine; good; first-rate;  
优美	優美	yoū měi	graceful; fine; elegant;  
优秀	優秀	yoū xiù	outstanding; excellent;  
邮局	郵局	yoú jú	post office; CL:家[jia1],個|个[ge4];  
有劲儿	有勁兒	yǒujìngér	Strength
有趣	有趣	yoǔ qù	interesting; fascinating; amusing;  
有限	有限	yoǔ xiàn	limited; finite;  
幼儿园	幼兒園	yoù ér yuán	kindergarten; nursery school;  
于是	於是	yú shì	thereupon; as a result; consequently; thus; hence;  
语法	語法	yǔ fǎ	grammar;  
语音	語音	yǔ yīn	speech sounds; pronunciation; colloquial (rather than literary) pronunciation of a Chinese character; phonetic; audio; voice; (Internet) to voice chat; voice message;  
玉	玉	yù	jade;  
玉米	玉米	yù mǐ	corn; maize; CL:粒[li4];  
预测	預測	yù cè	to forecast; to predict;  
预订	預訂	yù dìng	to place an order; to book ahead;  
遇	遇	Yù, yù	surname Yu;  to meet; to encounter; to treat; to receive; opportunity; chance;  
遇到	遇到	yù dào	to meet; to run into; to come across;  
遇见	遇見	yù jiàn	to meet;  
原料	原料	yuán liào	raw material; CL:個|个[ge4];  
原则	原則	yuán zé	principle; doctrine; CL:個|个[ge4];  
圆	圓	yuán	circle; round; circular; spherical; (of the moon) full; unit of Chinese currency (Yuan); tactful; to justify;  
圆满	圓滿	yuán mǎn	satisfactory; consummate; perfect;  
约会	約會	yuē huì	appointment; engagement; date; CL:次[ci4],個|个[ge4]; to arrange to meet;  
月底	月底	yuè dǐ	end of the month;  
阅读	閱讀	yuè dú	to read; reading;  
运动会	運動會	yùn dòng huì	sports competition; CL:個|个[ge4];  
运动员	運動員	yùn dòng yuán	athlete; CL:名[ming2],個|个[ge4];  
运气	運氣	yùn qi	luck (good or bad);  
运用	運用	yùn yòng	to use; to put to use;  
再三	再三	zài sān	over and over again; again and again;  
在乎	在乎	zài hu	to care about; equivalent of 在於|在于[zai4 yu2];  
在于	在於	zài yú	to be in; to lie in; to consist in; to depend on; to rest with;  
赞成	贊成	zàn chéng	to approve; to endorse; (literary) to assist;  
赞赏	贊賞	zàn shǎng	to admire; to praise; to appreciate;  
赞助	贊助	zàn zhù	to support; to assist; to sponsor;  
造型	造型	zào xíng	to model; to shape; appearance; style; design; form; pose;  
战斗	戰鬥	zhàn doù	to fight; to battle; CL:場|场[chang2],次[ci4];  
战胜	戰勝	zhàn shèng	to prevail over; to defeat; to surmount;  
战士	戰士	zhàn shì	fighter; soldier; warrior; CL:個|个[ge4];  
战争	戰爭	zhàn zhēng	war; conflict; CL:場|场[chang2],次[ci4];  
丈夫	丈夫	zhàng fu	husband; CL:個|个[ge4];  
招呼	招呼	zhāo hu	to call out to; to greet; to say hello to; to inform; to take care of; to take care that one does not;  
着	著	zhāo, zháo, zhe, zhuó	(chess) move; trick; all right!; (dialect) to add;  to touch; to come in contact with; to feel; to be affected by; to catch fire; to burn; (coll.) to fall asleep; (after a verb) hitting the mark; succeeding in;  aspect particle indicating action in progress;  to wear (clothes); to contact; to use; to apply;  
着火	著火	zháo huǒ	to ignite; to burn;  
着急	著急	zháo jí	to worry; to feel anxious; Taiwan pr. [zhao1 ji2];  
召开	召開	zhào kāi	to convene (a conference or meeting); to convoke; to call together;  
折	摺	shé, zhē, zhé, zhé	to break (e.g. stick or bone); a loss;  to turn sth over; to turn upside down; to tip sth out (of a container);  variant of 折[zhe2]; to fold;  
针	針	zhēn, zhēn	variant of 針|针[zhen1], needle;  
针对	針對	zhēn duì	to target; to focus on; to be aimed at or against; in response to;  
阵	陣	zhèn	disposition of troops; wave; spate; burst; spell; short period of time; classifier for events or states of short duration;  
争论	爭論	zhēng lùn	to argue; to debate; to contend; argument; contention; controversy; debate; CL:次[ci4],場|场[chang3];  
征服	徵服	zhēng fú	to conquer; to subdue; to vanquish;  
征求	徵求	zhēng qiú	to solicit; to seek; to request (opinions, feedback etc); to petition;  
政府	政府	zhèng fǔ	government; CL:個|个[ge4];  
政治	政治	zhèng zhì	politics; political;  
之后	之後	zhī hoù	afterwards; following; later; after;  
之间	之間	zhī jiān	between; among; inter-;  
之前	之前	zhī qián	before; prior to; ago; previously; beforehand;  
之一	之一	zhī yī	one of (sth); one out of a multitude; one (third, quarter, percent etc);  
支	支	Zhī, zhī	surname Zhi;  to support; to sustain; to erect; to raise; branch; division; to draw money; classifier for rods such as pens and guns, for army divisions and for songs or compositions;  
植物	植物	zhí wù	plant; vegetation; CL:種|种[zhong3];  
指挥	指揮	zhǐ huī	to conduct; to command; to direct; conductor (of an orchestra); CL:個|个[ge4];  
制订	製訂	zhì dìng	to work out; to formulate;  
质量	質量	zhì liàng	quality; (physics) mass; CL:個|个[ge4];  
治	治	zhì	to rule; to govern; to manage; to control; to harness (a river); to treat (a disease); to wipe out (a pest); to punish; to research;  
治疗	治療	zhì liáo	to treat (an illness); medical treatment; therapy;  
智力	智力	zhì lì	intelligence; intellect;  
智能	智能	zhì néng	intelligent; able; smart (phone, system, bomb etc);  
中介	中介	zhōng jiè	to act as intermediary; to link; intermediate; inter-; agency; agent;  
种类	種類	zhǒng lèi	kind; genus; type; category; variety; species; sort; class;  
中奖	中奬	zhòng jiǎng	to win a prize; a successful gamble;  
种	種	zhǒng, zhòng	seed; species; kind; type; classifier for types, kinds, sorts;  to plant; to grow; to cultivate;  
种植	種植	zhòng zhí	to plant; to grow;  
重量	重量	zhòng liàng	weight; CL:個|个[ge4];  
逐步	逐步	zhú bù	progressively; step by step;  
逐渐	逐漸	zhú jiàn	gradually;  
主题	主題	zhǔ tí	theme; subject;  
主席	主席	zhǔ xí	chairperson; premier; chairman; CL:個|个[ge4],位[wei4];  
祝福	祝福	zhù fú	blessings; to wish sb well;  
著名	著名	zhù míng	famous; noted; well-known; celebrated;  
著作	著作	zhù zuò	to write; literary work; book; article; writings; CL:部[bu4];  
抓紧	抓緊	zhuā jǐn	to grasp firmly; to pay special attention to; to rush in; to make the most of;  
专心	專心	zhuān xīn	to concentrate; absorption; concentration; engrossed;  
转动	轉動	zhuǎn dòng, zhuàn dòng	to turn sth around; to swivel;  to rotate (about an axis); to revolve; to turn; to move in a circle; to gyrate;  
转告	轉告	zhuǎn gào	to pass on; to communicate; to transmit;  
转身	轉身	zhuǎn shēn	(of a person) to turn round; to face about; (of a widow) to remarry (archaic);  
转弯	轉彎	zhuǎn wān	to turn; to go around a corner;  
转移	轉移	zhuǎn yí	to shift; to divert or distract (attention etc); to change; to transform; metastasis (medicine); to evacuate (people);  
装修	裝修	zhuāng xiū	to decorate; interior decoration; to fit up; to renovate;  
装置	裝置	zhuāng zhì	to install; installation; equipment; system; unit; device;  
追求	追求	zhuī qiú	to pursue (a goal etc) stubbornly; to seek after; to woo;  
准时	準時	zhǔn shí	on time; punctual; on schedule;  
资料	資料	zī liào	material; resources; data; information; profile (Internet); CL:份[fen4],個|个[ge4];  
资源	資源	Zī yuán, zī yuán	Ziyuan county in Guilin 桂林[Gui4 lin2], Guangxi;  natural resource (such as water or minerals); resource (such as manpower or tourism);  
自	自	zì	self; oneself; from; since; naturally; surely;  
自信	自信	zì xìn	to have confidence in oneself; self-confidence;  
字母	字母	zì mǔ	letter (of the alphabet); CL:個|个[ge4];  
综合	綜閤	zōng hé	comprehensive; composite; synthesized; mixed; to sum up; to integrate; to synthesize;  
总共	總共	zǒng gòng	altogether; in sum; in all; in total;  
总理	總理	zǒng lǐ	premier; prime minister; CL:個|个[ge4],位[wei4],名[ming2];  
总统	總統	zǒng tǒng	president (of a country); CL:個|个[ge4],位[wei4],名[ming2],屆|届[jie4];  
总之	總之	zǒng zhī	in a word; in short; in brief;  
阻止	阻止	zǔ zhǐ	to prevent; to block;  
嘴巴	嘴巴	zuǐ ba	mouth; CL:張|张[zhang1]; slap in the face; CL:個|个[ge4];  
最初	最初	zuì chū	first; primary; initial; original; at first; initially; originally;  
作出	作齣	zuò chū	to put out; to come up with; to make (a choice, decision, proposal, response, comment etc); to issue (a permit, statement, explanation, apology, reassurance to the public etc); to draw (conclusion); to deliver (speech, judgment); to devise (explanation); to extract;  
作为	作為	zuò wéi	one's conduct; deed; activity; accomplishment; achievement; to act as; as (in the capacity of); qua; to view as; to look upon (sth as); to take sth to be;  
做梦	做夢	zuò mèng	to dream; to have a dream; fig. illusion; fantasy; pipe dream;  
