爱	愛	ài	to love; to be fond of; to like; affection; to be inclined (to do sth); to tend to (happen);  
爱好	愛好	ài hào	to like; to take pleasure in; keen on; fond of; interest; hobby; appetite for; CL:個|个[ge4];  
八	八	bā	eight; 8;  
爸爸	爸爸	bà ba	(informal) father; CL:個|个[ge4],位[wei4];  
吧	吧	bā, ba	bar (loanword) (serving drinks, or providing Internet access etc); to puff (on a pipe etc); (onom.) bang; abbr. for 貼吧|贴吧[tie1 ba1];  (modal particle indicating suggestion or surmise); ...right?; ...OK?; ...I presume.;  
白	白	Bái, bái	surname Bai;  white; snowy; pure; bright; empty; blank; plain; clear; to make clear; in vain; gratuitous; free of charge; reactionary; anti-communist; funeral; to stare coldly; to write wrong character; to state; to explain; vernacular; spoken lines in opera;  
白天	白天	bái tiān	daytime; during the day; day; CL:個|个[ge4];  
百	百	Bǎi, bǎi	surname Bai;  hundred; numerous; all kinds of;  
班	班	Bān, bān	surname Ban;  team; class; squad; work shift; ranking; CL:個|个[ge4]; classifier for groups;  
半	半	bàn	half; semi-; incomplete; (after a number) and a half;  
半年	半年	bàn nián	half a year;  
半天	半天	bàn tiān	half of the day; a long time; quite a while; midair; CL:個|个[ge4];  
帮	幫	bāng, bāng, bāng	to help; to assist; to support; for sb (i.e. as a help); hired (as worker); side (of pail, boat etc); outer layer; upper (of a shoe); group; gang; clique; party; secret society;  
帮忙	幫忙	bāng máng	to help; to lend a hand; to do a favor; to do a good turn;  
包	包	Bāo, bāo	surname Bao;  to cover; to wrap; to hold; to include; to take charge of; to contract (to or for); package; wrapper; container; bag; to hold or embrace; bundle; packet; CL:個|个[ge4],隻|只[zhi1];  
包子	包子	bāo zi	steamed stuffed bun; CL:個|个[ge4];  
杯	杯	bēi, bēi, bēi	variant of 杯[bei1]; trophy cup; classifier for certain containers of liquids: glass, cup;  
杯子	杯子	bēi zi	cup; glass; CL:個|个[ge4],支[zhi1],枝[zhi1];  
北	北	běi	north; to be defeated (classical);  
北边	北邊	běi biān	north; north side; northern part; to the north of;  
北京	北京	Běi jīng	Beijing, capital of People's Republic of China; Peking; PRC government;  
本	本	běn	root; stem; origin; source; this; the current; original; inherent; originally; classifier for books, periodicals, files etc;  
本子	本子	běn zi	book; notebook; edition; CL:本[ben3];  
比	比	Bǐ, bǐ, bì	Belgium; Belgian; abbr. for 比利時|比利时[Bi3 li4 shi2];  (particle used for comparison and '-er than'); to compare; to contrast; to gesture (with hands); ratio;  to associate with; to be near;  
别	彆	Bié, bié, biè	surname Bie;  to leave; to depart; to separate; to distinguish; to classify; other; another; don't ...!; to pin; to stick (sth) in;  to make sb change their ways, opinions etc;  
别的	彆的	bié de	else; other;  
别人	彆人	bié ren	other people; others; other person;  
病	病	bìng	illness; CL:場|场[chang2]; disease; to fall ill; defect;  
病人	病人	bìng rén	sick person; patient; invalid; CL:個|个[ge4];  
不大	不大	bù dà	not very; not too; not often;  
不对	不對	bù duì	incorrect; wrong; amiss; abnormal; queer;  
不客气	不客氣	bù kè qi	you're welcome; don't mention it; impolite; rude; blunt;  
不用	不用	bù yòng	need not;  
不	不	bù	(negative prefix); not; no;  
菜	菜	cài	dish (type of food); vegetable; cuisine; CL:盤|盘[pan2],道[dao4]; (coll.) (one's) type;  
茶	茶	chá	tea; tea plant; CL:杯[bei1],壺|壶[hu2];  
差	差	chā, chà, chāi	difference; discrepancy; to differ; error; to err; to make a mistake;  to differ from; to fall short of; lacking; wrong; inferior;  to send; to commission; messenger; mission;  
常	常	Cháng, cháng	surname Chang;  always; ever; often; frequently; common; general; constant;  
常常	常常	cháng cháng	frequently; usually; often;  
唱	唱	chàng	to sing; to call loudly; to chant;  
唱歌	唱歌	chàng gē	to sing a song;  
车	車	Chē, chē, jū	surname Che;  car; vehicle; CL:輛|辆[liang4]; machine; to shape with a lathe;  war chariot (archaic); rook (in Chinese chess); rook (in chess);  
车票	車票	chē piào	ticket (for a bus or train);  
车上	車上	chēshàng	In the car
车站	車站	chē zhàn	rail station; bus stop; CL:處|处[chu4],個|个[ge4];  
吃	吃	chī, chī	variant of 吃[chi1];  
吃饭	吃飯	chī fàn	to have a meal; to eat; to make a living;  
出	齣	chū, chū	variant of 出[chu1] (classifier for plays or chapters of classical novels);  
出来	齣來	chū lái, chu lai	to come out; to appear; to arise;  (after a verb, indicates coming out, completion of an action, or ability to discern or detect);  
出去	齣去	chū qù	to go out;  
穿	穿	chuān	to wear; to put on; to dress; to bore through; to pierce; to perforate; to penetrate; to pass through; to thread;  
床	床	chuáng, chuáng	variant of 床[chuang2];  
次	次	cì	next in sequence; second; the second (day, time etc); secondary; vice-; sub-; infra-; inferior quality; substandard; order; sequence; hypo- (chemistry); classifier for enumerated events: time;  
从	從	Cóng, cóng, zòng	surname Cong;  from; through; via; to follow; to obey; to engage in (an activity); never (in negative sentence); (Taiwan pr. [zong4]) retainer; assistant; accomplice; related by common paternal grandfather or earlier ancestor;  second cousin;  
错	錯	Cuò, cuò	surname Cuo;  mistake; wrong; bad; interlocking; complex; to grind; to polish; to alternate; to stagger; to miss; to let slip; to evade; to inlay with gold or silver;  
打	打	dá, dǎ	dozen (loanword);  to beat; to strike; to hit; to break; to type; to mix up; to build; to fight; to fetch; to make; to tie up; to issue; to shoot; to calculate; to play (a game); since; from;  
打车	打車	dǎ chē	to take a taxi (in town); to hitch a lift;  
打电话	打電話	dǎ diàn huà	to make a telephone call;  
打开	打開	dǎ kāi	to open; to show (a ticket); to turn on; to switch on;  
打球	打球	dǎ qiú	to play ball; to play with a ball;  
大	大	dà, dài	big; huge; large; major; great; wide; deep; older (than); oldest; eldest; greatly; very much; (dialect) father; father's elder or younger brother;  see 大夫[dai4 fu5];  
大学	大學	Dà xué, dà xué	the Great Learning, one of the Four Books 四書|四书[Si4 shu1] in Confucianism;  university; college; CL:所[suo3];  
大学生	大學生	dà xué shēng	university student; college student;  
到	到	dào	to (a place); until (a time); up to; to go; to arrive; (verb complement denoting completion or result of an action);  
得到	得到	dé dào	to get; to obtain; to receive;  
地	地	de, dì	-ly; structural particle: used before a verb or adjective, linking it to preceding modifying adverbial adjunct;  earth; ground; field; place; land; CL:片[pian4];  
的	的	de, dī, dí, dì	of; ~'s (possessive particle); (used after an attribute); (used to form a nominal expression); (used at the end of a declarative sentence for emphasis);  see 的士[di1 shi4];  really and truly;  aim; clear;  
等	等	děng	class; rank; grade; equal to; same as; to wait for; to await; et cetera; and so on; et al. (and other authors); after; as soon as; once;  
地	地	de, dì	-ly; structural particle: used before a verb or adjective, linking it to preceding modifying adverbial adjunct;  earth; ground; field; place; land; CL:片[pian4];  
地点	地點	dì diǎn	place; site; location; venue; CL:個|个[ge4];  
地方	地方	dì fāng, dì fang	region; regional (away from the central administration); local;  area; place; space; room; territory; CL:處|处[chu4],個|个[ge4],塊|块[kuai4];  
地上	地上	dì shang	on the ground; on the floor;  
地图	地圖	dì tú	map; CL:張|张[zhang1],本[ben3];  
弟弟	弟弟	dì di	younger brother; CL:個|个[ge4],位[wei4];  
第	第	dì	(prefix indicating ordinal number, e.g. first, number two etc); order; (old) rank in the imperial examinations; mansion; (literary) but; just;  
点	點	diǎn	point; dot; drop; speck; o'clock; point (in space or time); to draw a dot; to check on a list; to choose; to order (food in a restaurant); to touch briefly; to hint; to light; to ignite; to pour a liquid drop by drop; (old) one fifth of a two-hour watch 更[geng1]; dot stroke in Chinese characters; classifier for items;  
电	電	diàn	electric; electricity; electrical;  
电话	電話	diàn huà	telephone; CL:部[bu4]; phone call; CL:通[tong1]; phone number;  
电脑	電腦	diàn nǎo	computer; CL:臺|台[tai2];  
电视	電視	diàn shì	television; TV; CL:臺|台[tai2],個|个[ge4];  
电视机	電視機	diàn shì jī	television set; CL:臺|台[tai2];  
电影	電影	diàn yǐng	movie; film; CL:部[bu4],片[pian4],幕[mu4],場|场[chang3];  
电影院	電影院	diàn yǐng yuàn	cinema; movie theater; CL:家[jia1],座[zuo4];  
东	東	Dōng, dōng	surname Dong;  east; host (i.e. sitting on east side of guest); landlord;  
东边	東邊	dōng bian	east; east side; eastern part; to the east of;  
东西	東西	dōng xī, dōng xi	east and west;  thing; stuff; person; CL:個|个[ge4],件[jian4];  
动	動	dòng	(of sth) to move; to set in movement; to displace; to touch; to make use of; to stir (emotions); to alter; abbr. for 動詞|动词[dong4 ci2], verb;  
动作	動作	dòng zuò	movement; motion; action; CL:個|个[ge4];  
都	都	Dū, doū, dū	surname Du;  all; both; entirely; (used for emphasis) even; already; (not) at all;  capital city; metropolis;  
读	讀	doù, dú	comma; phrase marked by pause;  to read; to study; reading of word (i.e. pronunciation), similar to 拼音[pin1 yin1];  
读书	讀書	dú shū	to read a book; to study; to attend school;  
对	對	duì	right; correct; couple; pair; towards; at; for; to face; opposite; to treat (sb a certain way); to match together; to adjust; to fit; to suit; to answer; to reply; classifier: couple;  
对不起	對不起	duì bu qǐ	unworthy; to let down; I'm sorry; excuse me; pardon me; if you please; sorry? (please repeat);  
多	多	duō	many; much; often; a lot of; numerous; more; in excess; how (to what extent); multi-; Taiwan pr. [duo2] when it means 'how';  
多少	多少	duō shǎo, duō shao	number; amount; somewhat;  how much; how many; which (number); as much as;  
饿	餓	è	to be hungry; hungry; to starve (sb);  
儿子	兒子	ér zi	son;  
二	二	èr	two; 2; (Beijing dialect) stupid;  
饭	飯	fàn	food; cuisine; cooked rice; meal; CL:碗[wan3],頓|顿[dun4];  
饭店	飯店	fàn diàn	restaurant; hotel; CL:家[jia1],個|个[ge4];  
房间	房間	fáng jiān	room; CL:間|间[jian1],個|个[ge4];  
房子	房子	fáng zi	house; building (single- or two-story); apartment; room; CL:棟|栋[dong4],幢[zhuang4],座[zuo4],套[tao4];  
放	放	fàng	to put; to place; to release; to free; to let go; to let out; to set off (fireworks);  
放假	放假	fàng jià	to have a holiday or vacation;  
放学	放學	fàng xué	to dismiss students at the end of the school day;  
飞	飛	fēi	to fly;  
飞机	飛機	fēi jī	airplane; CL:架[jia4];  
非常	非常	fēi cháng	very; very much; unusual; extraordinary;  
分	分	fēn, fèn	to divide; to separate; to distribute; to allocate; to distinguish (good and bad); part or subdivision; fraction; one tenth (of certain units); unit of length equivalent to 0.33 cm; minute; a point (in sports or games); 0.01 yuan (unit of money);  part; share; ingredient; component;  
风	風	fēng	wind; news; style; custom; manner; CL:陣|阵[zhen4],絲|丝[si1];  
干	乾	gān, Gān, gān, gān, gān, gàn	to concern; to interfere; shield; stem;  surname Gan;  tree trunk; main part of sth; to manage; to work; to do; capable; cadre; to kill (slang); to fuck (vulgar);  
干净	乾淨	gān jìng	clean; neat;  
干	乾	gān, Gān, gān, gān, gān, gàn	to concern; to interfere; shield; stem;  surname Gan;  tree trunk; main part of sth; to manage; to work; to do; capable; cadre; to kill (slang); to fuck (vulgar);  
干什么	乾什麼	gàn shén me	what are you doing?; what's he up to?;  
高	高	Gāo, gāo	surname Gao;  high; tall; above average; loud; your (honorific);  
高兴	高興	gāo xìng	happy; glad; willing (to do sth); in a cheerful mood;  
告诉	告訴	gào sù, gào su	to press charges; to file a complaint;  to tell; to inform; to let know;  
哥哥	哥哥	gē ge	older brother; CL:個|个[ge4],位[wei4];  
歌	歌	gē, gē	variant of 歌[ge1];  
个	個	gè, gè	variant of 個|个[ge4];  
给	給	gěi, jǐ	to; for; for the benefit of; to give; to allow; to do sth (for sb); (grammatical equivalent of 被); (grammatical equivalent of 把); (sentence intensifier);  to supply; to provide;  
跟	跟	gēn	heel; to follow closely; to go with; (of a woman) to marry sb; with; compared with; to; towards; and (joining two nouns);  
工人	工人	gōng rén	worker; CL:個|个[ge4],名[ming2];  
工作	工作	gōng zuò	to work; (of a machine) to operate; job; work; task; CL:個|个[ge4],份[fen4],項|项[xiang4];  
关	關	Guān, guān	surname Guan;  mountain pass; to close; to shut; to turn off; to concern; to involve;  
关上	關上	guān shàng	to close (a door); to turn off (light, electrical equipment etc);  
贵	貴	guì	expensive; noble; precious; (honorific) your;  
国	國	Guó, guó	surname Guo;  country; nation; state; national; CL:個|个[ge4];  
国家	國傢	guó jiā	country; nation; state; CL:個|个[ge4];  
国外	國外	guó wài	abroad; external (affairs); overseas; foreign;  
过	過	Guò, guò, guo	surname Guo;  to cross; to go over; to pass (time); to celebrate (a holiday); to live; to get along; excessively; too-;  (experienced action marker);  
还	還	Huán, hái, huán	surname Huan;  still; still in progress; still more; yet; even more; in addition; fairly; passably (good); as early as; even; also; else;  to pay back; to return;  
还是	還是	hái shi	or; still; nevertheless; had better;  
还有	還有	hái yoǔ	furthermore; in addition; still; also;  
孩子	孩子	hái zi	child;  
汉语	漢語	Hàn yǔ	Chinese language; CL:門|门[men2];  
汉字	漢字	hàn zì	Chinese character; CL:個|个[ge4]; Japanese: kanji; Korean: hanja; Vietnamese: hán tự;  
好	好	hǎo, hào	good; well; proper; good to; easy to; very; so; (suffix indicating completion or readiness); (of two people) close; on intimate terms;  to be fond of; to have a tendency to; to be prone to;  
好吃	好吃	hǎo chī, hào chī	tasty; delicious;  to be fond of eating; to be gluttonous;  
好看	好看	hǎo kàn	good-looking; nice-looking; good (of a movie, book, TV show etc); embarrassed; humiliated;  
好听	好聽	hǎo tīng	pleasant to hear;  
好玩儿	好玩兒	hao3 wan2 r5	interesting; delightful; amusing;  
号	號	háo, hào	roar; cry; CL:個|个[ge4];  ordinal number; day of a month; mark; sign; business establishment; size; ship suffix; horn (wind instrument); bugle call; assumed name; to take a pulse; classifier used to indicate number of people;  
喝	喝	hē, hè	to drink; My goodness!;  to shout loudly;  
和	和	hé, Hé, hé, hè, hú, huó, huò, hé	old variant of 和[he2]; harmonious;  surname He; Japanese (food, clothes etc);  to compose a poem in reply (to sb's poem) using the same rhyme sequence; to join in the singing; to chime in with others;  to complete a set in mahjong or playing cards;  to combine a powdery substance (flour, plaster etc) with water; Taiwan pr. [huo4];  to mix (ingredients) together; to blend; classifier for rinses of clothes; classifier for boilings of medicinal herbs;  
很	很	hěn	(adverb of degree); quite; very; awfully;  
后	後	Hoù, hoù, hoù	surname Hou;  back; behind; rear; afterwards; after; later;  
后边	後邊	hoù bian	back; rear; behind;  
后天	後天	hoù tiān	the day after tomorrow; post-natal; acquired (not innate); a posteriori;  
花	花	Huā, huā, huā, huā	surname Hua;  variant of 花[hua1]; flower; blossom; also pr. [wei3];  
话	話	huà, huà	old variant of 話|话[hua4];  
坏	壞	huài	bad; spoiled; broken; to break down; (suffix) to the utmost;  
还	還	Huán, hái, huán	surname Huan;  still; still in progress; still more; yet; even more; in addition; fairly; passably (good); as early as; even; also; else;  to pay back; to return;  
回	迴	huí, huí, huí	variant of 迴|回[hui2];  
回答	迴答	huí dá	to reply; to answer; the answer; CL:個|个[ge4];  
回到	迴到	huí dào	to return to;  
回家	迴傢	huí jiā	to return home;  
回来	迴來	huí lai	to return; to come back;  
回去	迴去	huí qu	to return; to go back;  
会	會	huì, kuài	can; to be possible; to be able to; will; to be likely to; to be sure to; to assemble; to meet; to gather; to see; union; group; association; CL:個|个[ge4]; a moment (Taiwan pr. for this sense is [hui3]);  to balance an account; accountancy; accounting;  
火车	火車	huǒ chē	train; CL:列[lie4],節|节[jie2],班[ban1],趟[tang4];  
机场	機場	jī chǎng	airport; airfield; CL:家[jia1],處|处[chu4];  
机票	機票	jī piào	air ticket; passenger ticket; CL:張|张[zhang1];  
鸡蛋	雞蛋	jī dàn	(chicken) egg; hen's egg; CL:個|个[ge4],打[da2];  
几	幾	jī, jī, jǐ	almost;  how much; how many; several; a few;  
记	記	jì	to record; to note; to memorize; to remember; mark; sign; classifier for blows, kicks, shots;  
记得	記得	jì de	to remember;  
记住	記住	jì zhu	to remember; to bear in mind; to learn by heart;  
家	傢	jiā, Jiā, jiā	home; family; (polite) my (sister, uncle etc); classifier for families or businesses; refers to the philosophical schools of pre-Han China; noun suffix for a specialist in some activity, such as a musician or revolutionary, corresponding to English -ist, -er, -ary or -ian; CL:個|个[ge4];  surname Jia;  
家里	傢裏	jiā lǐ	home;  
家人	傢人	jiā rén	household; (one's) family;  
间	間	jiān, jiàn	between; among; within a definite time or space; room; section of a room or lateral space between two pairs of pillars; classifier for rooms;  gap; to separate; to thin out (seedlings); to sow discontent;  
见	見	jiàn, xiàn	to see; to meet; to appear (to be sth); to interview;  to appear; also written 現|现[xian4];  
见面	見麵	jiàn miàn	to meet; to see each other; CL:次[ci4];  
教	教	Jiào, jiāo, jiào	surname Jiao;  to teach;  religion; teaching; to make; to cause; to tell;  
叫	叫	jiào, jiào	variant of 叫[jiao4];  
教学楼	教學樓	jiào xué loú	teaching block; school building;  
姐姐	姐姐	jiě jie	older sister; CL:個|个[ge4];  
介绍	介紹	jiè shào	to introduce (sb to sb); to give a presentation; to present (sb for a job etc); introduction;  
今年	今年	jīn nián	this year;  
今天	今天	jīn tiān	today; at the present; now;  
进	進	jìn	to go forward; to advance; to go in; to enter; to put in; to submit; to take in; to admit; (math.) base of a number system; classifier for sections in a building or residential compound;  
进来	進來	jìn lái	to come in;  
进去	進去	jìn qù	to go in;  
九	九	jiǔ	nine; 9;  
就	就	jiù	at once; right away; only; just (emphasis); as early as; already; as soon as; then; in that case; as many as; even if; to approach; to move towards; to undertake; to engage in; to suffer; subjected to; to accomplish; to take advantage of; to go with (of foods); with regard to; concerning;  
觉得	覺得	jué de	to think; to feel;  
开	開	kāi	to open; to start; to turn on; to boil; to write out (a prescription, check, invoice etc); to operate (a vehicle); carat (gold); abbr. for Kelvin, 開爾文|开尔文[Kai1 er3 wen2]; abbr. for 開本|开本[kai1 ben3], book format;  
开车	開車	kāi chē	to drive a car;  
开会	開會	kāi huì	to hold a meeting; to attend a meeting;  
开玩笑	開玩笑	kāi wán xiào	to play a joke; to make fun of; to joke;  
看	看	kān, kàn	to look after; to take care of; to watch; to guard;  to see; to look at; to read; to watch; to visit; to call on; to consider; to regard as; to look after; to treat (an illness); to depend on; to feel (that); (after verb) to give it a try; Watch out! (for a danger);  
看病	看病	kàn bìng	to visit a doctor; to see a patient;  
看到	看到	kàndào	see
看见	看見	kàn jiàn	to see; to catch sight of;  
考	考	kǎo, kǎo	to check; to verify; to test; to examine; to take an exam; to take an entrance exam for; deceased father;  
考试	考試	kǎo shì	to take an exam; exam; CL:次[ci4];  
渴	渴	kě	thirsty;  
课	課	kè	subject; course; CL:門|门[men2]; class; lesson; CL:堂[tang2],節|节[jie2]; to levy; tax; form of divination;  
课本	課本	kè běn	textbook; CL:本[ben3];  
课文	課文	kè wén	text; CL:篇[pian1];  
口	口	koǔ	mouth; classifier for things with mouths (people, domestic animals, cannons, wells etc); classifier for bites or mouthfuls;  
块	塊	kuài	lump (of earth); chunk; piece; classifier for pieces of cloth, cake, soap etc; (coll.) classifier for money and currency units;  
快	快	kuài	rapid; quick; speed; rate; soon; almost; to make haste; clever; sharp (of knives or wits); forthright; plainspoken; gratified; pleased; pleasant;  
来	來	lái	to come; to arrive; to come round; ever since; next;  
来到	來到	lái dào	to come; to arrive;  
老	老	lǎo	prefix used before the surname of a person or a numeral indicating the order of birth of the children in a family or to indicate affection or familiarity; old (of people); venerable (person); experienced; of long standing; always; all the time; of the past; very; outdated; (of meat etc) tough;  
老人	老人	lǎo rén	old man or woman; the elderly; one's aged parents or grandparents;  
老师	老師	lǎo shī	teacher; CL:個|个[ge4],位[wei4];  
了	瞭	le, liǎo, liǎo, liào	(modal particle intensifying preceding clause); (completed action marker);  (of eyes) bright; clear-sighted; to understand clearly;  unofficial variant of 瞭[liao4];  
累	纍	lěi, lèi, Léi, léi	to accumulate; to involve or implicate (Taiwan pr. [lei4]); continuous; repeated;  tired; weary; to strain; to wear out; to work hard;  surname Lei;  rope; to bind together; to twist around;  
冷	冷	Lěng, lěng	surname Leng;  cold;  
里	裏	lǐ, lǐ, Lǐ, lǐ	li, ancient measure of length, approx. 500 m; neighborhood; ancient administrative unit of 25 families; (Tw) borough, administrative unit between the township 鎮|镇[zhen4] and neighborhood 鄰|邻[lin2] levels;  Li (surname);  
里边	裏邊	lǐ bian	inside;  
两	兩	liǎng	two; both; some; a few; tael, unit of weight equal to 50 grams (modern) or 1⁄16 of a catty 斤[jin1] (old);  
零	零	líng	zero; nought; zero sign; fractional; fragmentary; odd (of numbers); (placed between two numbers to indicate a smaller quantity followed by a larger one); fraction; (in mathematics) remainder (after division); extra; to wither and fall; to wither;  
六	六	liù	six; 6;  
楼	樓	Loú, loú	surname Lou;  house with more than 1 story; storied building; floor; CL:層|层[ceng2],座[zuo4],棟|栋[dong4];  
楼上	樓上	loú shàng	upstairs;  
楼下	樓下	loú xià	downstairs;  
路	路	Lù, lù	surname Lu;  road; CL:條|条[tiao2]; journey; route; line (bus etc); sort; kind;  
路口	路口	lù koǔ	crossing; intersection (of roads);  
路上	路上	lù shang	on the road; on a journey; road surface;  
妈妈	媽媽	mā ma	mama; mommy; mother; CL:個|个[ge4],位[wei4];  
马路	馬路	mǎ lù	street; road; CL:條|条[tiao2];  
马上	馬上	mǎ shàng	at once; right away; immediately; on horseback (i.e. by military force);  
吗	嗎	mǎ, ma	see 嗎啡|吗啡, morphine;  (question particle for 'yes-no' questions);  
买	買	mǎi	to buy; to purchase;  
慢	慢	màn	slow;  
忙	忙	máng	busy; hurriedly; to hurry; to rush;  
毛	毛	Máo, máo	surname Mao;  hair; feather; down; wool; mildew; mold; coarse or semifinished; young; raw; careless; unthinking; nervous; scared; (of currency) to devalue or depreciate; classifier for Chinese fractional monetary unit ( = 角[jiao3] , = one-tenth of a yuan or 10 fen 分[fen1]);  
没	沒	méi, mò	(negative prefix for verbs); have not; not;  drowned; to end; to die; to inundate;  
没关系	沒關係	méi guān xi	it doesn't matter;  
没什么	沒什麼	méi shén me, méi shén me	nothing; it doesn't matter; it's nothing; never mind;  
没事儿	沒事兒	mei2 shi4 r5	to have spare time; free from work; it's not important; it's nothing; never mind;  
没有	沒有	méi yoǔ	haven't; hasn't; doesn't exist; to not have; to not be;  
妹妹	妹妹	mèi mei	younger sister; young woman; CL:個|个[ge4];  
门	門	Mén, mén	surname Men;  gate; door; CL:扇[shan4]; gateway; doorway; CL:個|个[ge4]; opening; valve; switch; way to do something; knack; family; house; (religious) sect; school (of thought); class; category; phylum or division (taxonomy); classifier for large guns; classifier for lessons, subjects, branches of technology; (suffix) -gate (i.e. scandal; derived from Watergate);  
门口	門口	mén koǔ	doorway; gate; CL:個|个[ge4];  
门票	門票	mén piào	ticket (for theater, cinema etc);  
们	們	men	plural marker for pronouns, and nouns referring to individuals;  
米饭	米飯	mǐ fàn	(cooked) rice;  
面包	麵包	miàn bāo	bread; CL:片[pian4],袋[dai4],塊|块[kuai4];  
面条儿	麵條兒	mian4 tiao2 r5	erhua variant of 麵條|面条[mian4 tiao2];  
名字	名字	míng zi	name (of a person or thing); CL:個|个[ge4];  
明白	明白	míng bai	clear; obvious; unequivocal; to understand; to realize;  
明年	明年	míng nián	next year;  
明天	明天	míng tiān	tomorrow;  
拿	拿	ná, ná, ná	to hold; to seize; to catch; to apprehend; to take; (used in the same way as 把[ba3]: to mark the following noun as a direct object);  
哪	哪	nǎ, na, něi	how; which;  (particle equivalent to 啊 after noun ending in -n);  which? (interrogative, followed by classifier or numeral-classifier);  
哪里	哪裏	nǎ lǐ, nǎ lǐ	where?; somewhere; anywhere; wherever; nowhere (negative answer to question); humble expression denying compliment;  
哪儿	哪兒	na3 r5	where?; wherever; anywhere;  
哪些	哪些	nǎ xiē	which ones?; who?; what?;  
那	那	Nā, Nuó, nǎ, nà, nuó	surname Na;  surname Nuo;  variant of 哪[na3];  that; those; then (in that case); commonly pr. [nei4] before a classifier, esp. in Beijing;  (archaic) many; beautiful; how; old variant of 挪[nuo2];  
那边	那邊	nà bian	over there; yonder;  
那里	那裏	nà li, nà li	there; that place;  
那儿	那兒	na4 r5	there;  
那些	那些	nà xiē	those;  
奶	奶	nǎi, nǎi, nǎi	mother; variant of 奶[nai3];  
奶奶	奶奶	nǎi nai	(informal) grandma (paternal grandmother); (respectful) mistress of the house; CL:位[wei4]; (coll.) boobies; breasts;  
男	男	nán	male; Baron, lowest of five orders of nobility 五等爵位[wu3 deng3 jue2 wei4]; CL:個|个[ge4];  
男孩儿	男孩兒	nan2 hai2 r5	erhua variant of 男孩[nan2 hai2];  
男朋友	男朋友	nán péng you	boyfriend;  
男人	男人	nán rén	a man; a male; men; CL:個|个[ge4];  
男生	男生	nán shēng	schoolboy; male student; boy; guy (young adult male);  
南	南	Nán, nán	surname Nan;  south;  
南边	南邊	nán bian	south; south side; southern part; to the south of;  
难	難	nán, nàn	difficult (to...); problem; difficulty; difficult; not good;  disaster; distress; to scold;  
呢	呢	ne, ní	particle indicating that a previously asked question is to be applied to the preceding word ('What about ...?', 'And ...?'); particle for inquiring about location ('Where is ...?'); particle signaling a pause, to emphasize the preceding words and allow the listener time to take them on board ('ok?', 'are you with me?'); (at the end of a declarative sentence) particle indicating continuation of a state or action; particle indicating strong affirmation;  woolen material;  
能	能	Néng, néng	surname Neng;  can; to be able to; might possibly; ability; (physics) energy;  
你	你	nǐ	you (informal, as opposed to courteous 您[nin2]);  
你们	你們	nǐ men	you (plural);  
年	年	Nián, nián, nián	surname Nian;  grain; harvest (old); variant of 年[nian2];  
您	您	nín	you (courteous, as opposed to informal 你[ni3]);  
牛奶	牛奶	niú nǎi	cow's milk; CL:瓶[ping2],杯[bei1];  
女	女	nǚ, rǔ	female; woman; daughter;  archaic variant of 汝[ru3];  
女儿	女兒	nǚ ér	daughter;  
女孩儿	女孩兒	nu:3 hai2 r5	erhua variant of 女孩[nu:3 hai2];  
女朋友	女朋友	nǚ péng you	girlfriend;  
女人	女人	nǚ rén, nǚ ren	woman;  wife;  
女生	女生	nǚ shēng	schoolgirl; female student; girl;  
旁边	旁邊	páng biān	lateral; side; to the side; beside;  
跑	跑	páo, pǎo	(of an animal) to paw (the ground);  to run; to run away; to escape; to run around (on errands etc); (of a gas or liquid) to leak or evaporate; (verb complement) away; off;  
朋友	朋友	péng you	friend; CL:個|个[ge4],位[wei4];  
票	票	piào	ticket; ballot; banknote; CL:張|张[zhang1]; person held for ransom; amateur performance of Chinese opera; classifier for groups, batches, business transactions;  
七	七	qī	seven; 7;  
起	起	qǐ	to rise; to raise; to get up; to set out; to start; to appear; to launch; to initiate (action); to draft; to establish; to get (from a depot or counter); verb suffix, to start; starting from (a time, place, price etc); classifier for occurrences or unpredictable events: case, instance; classifier for groups: batch, group;  
起床	起床	qǐ chuáng	to get out of bed; to get up;  
起来	起來	qǐ lai, qi lai	to stand up; to get up; also pr. [qi3 lai2];  (after a verb) indicating the beginning and continuation of an action or a state; indicating an upward movement (e.g. after 站[zhan4]); bringing things together (e.g. after 收拾[shou1 shi5]); (after a perception verb, e.g. 看[kan4]) expressing preliminary judgment; also pr. [qi3 lai5];  
汽车	汽車	qì chē	car; automobile; bus; CL:輛|辆[liang4];  
前	前	qián	front; forward; ahead; first; top (followed by a number); future; ago; before; BC (e.g. 前293年); former; formerly;  
前边	前邊	qián bian	front; the front side; in front of;  
前天	前天	qián tiān	the day before yesterday;  
钱	錢	Qián, qián	surname Qian;  coin; money; CL:筆|笔[bi3]; unit of weight, one tenth of a tael 兩|两[liang3];  
钱包	錢包	qián bāo	purse; wallet;  
请	請	qǐng	to ask; to invite; please (do sth); to treat (to a meal etc); to request;  
请假	請假	qǐng jià	to request leave of absence;  
请进	請進	qǐng jìn	'please come in';  
请问	請問	qǐng wèn	Excuse me, may I ask...?;  
请坐	請坐	qǐngzuò	Please sit down
球	球	qiú	ball; sphere; globe; CL:個|个[ge4]; ball game; match; CL:場|场[chang3];  
去	去	qù	to go; to go to (a place); (of a time etc) last; just passed; to send; to remove; to get rid of; to reduce; to be apart from in space or time; to die (euphemism); to play (a part); (when used either before or after a verb) to go in order to do sth; (after a verb of motion indicates movement away from the speaker); (used after certain verbs to indicate detachment or separation);  
去年	去年	qù nián	last year;  
热	熱	rè	to warm up; to heat up; hot (of weather); heat; fervent;  
人	人	rén	man; person; people; CL:個|个[ge4],位[wei4];  
认识	認識	rèn shi	to know; to recognize; to be familiar with; to get acquainted with sb; knowledge; understanding; awareness; cognition;  
认真	認真	rèn zhēn	conscientious; earnest; serious; to take seriously; to take to heart;  
日	日	Rì, rì	abbr. for 日本[Ri4 ben3], Japan;  sun; day; date, day of the month;  
日期	日期	rì qī	date; CL:個|个[ge4];  
肉	肉	roù	meat; flesh; pulp (of a fruit); (coll.) (of a fruit) squashy; (of a person) flabby; irresolute;  
三	三	Sān, sān	surname San;  three; 3;  
山	山	Shān, shān	surname Shan;  mountain; hill; anything that resembles a mountain; CL:座[zuo4]; bundled straw in which silkworms spin cocoons; gable;  
商场	商場	shāng chǎng	shopping mall; shopping center; department store; emporium; CL:家[jia1]; the business world;  
商店	商店	shāng diàn	store; shop; CL:家[jia1],個|个[ge4];  
上	上	shǎng, shàng	see 上聲|上声[shang3 sheng1];  on top; upon; above; upper; previous; first (of multiple parts); to climb; to get onto; to go up; to attend (class or university);  
上班	上班	shàng bān	to go to work; to be on duty; to start work; to go to the office;  
上边	上邊	shàng bian	the top; above; overhead; upwards; the top margin; above-mentioned; those higher up;  
上车	上車	shàng chē	to get on or into (a bus, train, car etc);  
上次	上次	shàng cì	last time;  
上课	上課	shàng kè	to go to class; to attend class; to go to teach a class;  
上网	上網	shàng wǎng	to go online; to connect to the Internet; (of a document etc) to be uploaded to the Internet; (tennis, volleyball etc) to move in close to the net;  
上午	上午	shàng wǔ	morning; CL:個|个[ge4];  
上学	上學	shàng xué	to go to school; to attend school;  
少	少	shǎo, shào	few; less; to lack; to be missing; to stop (doing sth); seldom;  young;  
谁	誰	shéi	who; also pr. [shui2];  
身上	身上	shēn shang	on the body; at hand; among;  
身体	身體	shēn tǐ	the body; one's health; CL:具[ju4],個|个[ge4]; in person;  
什么	什麼	shén me	what?; who?; something; anything;  
生病	生病	shēng bìng	to fall ill;  
生气	生氣	shēng qì	to get angry; to take offense; angry; vitality; liveliness;  
生日	生日	shēng rì	birthday; CL:個|个[ge4];  
十	十	shí	ten; 10;  
时候	時候	shí hou	time; length of time; moment; period;  
时间	時間	shí jiān	time; period; CL:段[duan4];  
事	事	shì	matter; thing; item; work; affair; CL:件[jian4],樁|桩[zhuang1],回[hui2];  
试	試	shì	to test; to try; experiment; examination; test;  
是	是	shì, shì	variant of 是[shi4]; (used in given names);  
是不是	是不是	shì bù shì	is or isn't; yes or no; whether or not;  
手	手	shoǔ	hand; (formal) to hold; person engaged in certain types of work; person skilled in certain types of work; personal(ly); convenient; classifier for skill; CL:雙|双[shuang1],隻|只[zhi1];  
手机	手機	shoǔ jī	cell phone; mobile phone; CL:部[bu4],支[zhi1];  
书	書	Shū, shū	abbr. for 書經|书经[Shu1 jing1];  book; letter; document; CL:本[ben3],冊|册[ce4],部[bu4]; to write;  
书包	書包	shū bāo	schoolbag; satchel; CL:個|个[ge4],隻|只[zhi1];  
书店	書店	shū diàn	bookstore; CL:家[jia1];  
树	樹	shù	tree; CL:棵[ke1]; to cultivate; to set up;  
水	水	Shuǐ, shuǐ	surname Shui;  water; river; liquid; beverage; additional charges or income; (of clothes) classifier for number of washes;  
水果	水果	shuǐ guǒ	fruit; CL:個|个[ge4];  
睡	睡	shuì	to sleep; to lie down;  
睡觉	睡覺	shuì jiào	to go to bed; to sleep;  
说	說	shuì, shuō	to persuade;  to speak; to say; to explain; to scold; to tell off; a theory (usually in compounds such as 日心说 heliocentric theory);  
说话	說話	shuō huà	to speak; to say; to talk; to gossip; to tell stories; talk; word;  
四	四	sì	four; 4;  
送	送	sòng	to deliver; to carry; to give (as a present); to present (with); to see off; to send;  
岁	歲	suì, suì	classifier for years (of age); year; year (of crop harvests);  
他	他	tā	he or him; (used for either sex when the sex is unknown or unimportant); (used before sb's name for emphasis); (used as a meaningless mock object); other; another;  
他们	他們	tā men	they;  
她	她	tā	she;  
她们	她們	tā men	they; them (for females);  
太	太	tài	highest; greatest; too (much); very; extremely;  
天	天	tiān	day; sky; heaven;  
天气	天氣	tiān qì	weather;  
听	聽	yǐn, tīng, tìng	smile (archaic);  to listen; to hear; to obey; a can (loanword from English 'tin'); classifier for canned beverages;  (literary pronunciation, still advocated in Taiwan) to rule; to sentence; to allow;  
听到	聽到	tīng dào	to hear;  
听见	聽見	tīng jiàn	to hear;  
听写	聽寫	tīng xiě	dictate; dictation; CL:次[ci4];  
同学	同學	tóng xué	to study at the same school; fellow student; classmate; CL:位[wei4],個|个[ge4];  
图书馆	圖書館	tú shū guǎn	library; CL:家[jia1],個|个[ge4];  
外	外	wài	outside; in addition; foreign; external;  
外边	外邊	wài bian	outside; outer surface; abroad; place other than one's home;  
外国	外國	wài guó	foreign (country); CL:個|个[ge4];  
外语	外語	wài yǔ	foreign language; CL:門|门[men2];  
玩儿	玩兒	wan2 r5	to play; to have fun; to hang out;  
晚	晚	wǎn	evening; night; late;  
晚饭	晚飯	wǎn fàn	evening meal; dinner; supper; CL:份[fen4],頓|顿[dun4],次[ci4],餐[can1];  
晚上	晚上	wǎn shang	evening; night; CL:個|个[ge4]; in the evening;  
网上	網上	wǎng shàng	online;  
网友	網友	wǎng yoǔ	online friend; Internet user;  
忘	忘	wàng	to forget; to overlook; to neglect;  
忘记	忘記	wàng jì	to forget;  
问	問	wèn	to ask;  
我	我	wǒ	I; me; my;  
我们	我們	wǒ men	we; us; ourselves; our;  
五	五	wǔ	five; 5;  
午饭	午飯	wǔ fàn	lunch; CL:份[fen4],頓|顿[dun4],次[ci4],餐[can1];  
西	西	Xī, xī	the West; abbr. for Spain 西班牙[Xi1 ban1 ya2]; Spanish;  west;  
西边	西邊	xī biān	west; west side; western part; to the west of;  
洗	洗	xǐ	to wash; to bathe; to develop (photo);  
洗手间	洗手間	xǐ shoǔ jiān	toilet; lavatory; washroom;  
喜欢	喜歡	xǐ huan	to like; to be fond of;  
下	下	xià	down; downwards; below; lower; later; next (week etc); second (of two parts); to decline; to go down; to arrive at (a decision, conclusion etc); measure word to show the frequency of an action;  
下班	下班	xià bān	to finish work; to get off work;  
下边	下邊	xià bian	under; the underside; below;  
下车	下車	xià chē	to get off or out of (a bus, train, car etc);  
下次	下次	xià cì	next time;  
下课	下課	xià kè	to finish class; to get out of class;  
下午	下午	xià wǔ	afternoon; CL:個|个[ge4]; p.m.;  
下雨	下雨	xià yǔ	to rain;  
先	先	xiān	early; prior; former; in advance; first;  
先生	先生	Xiān sheng, xiān sheng	Mister (Mr.);  teacher; husband; doctor (dialect); CL:位[wei4];  
现在	現在	xiàn zài	now; at present; at the moment; modern; current; nowadays;  
想	想	xiǎng	to think; to believe; to suppose; to wish; to want; to miss (feel wistful about the absence of sb or sth);  
小	小	xiǎo	small; tiny; few; young;  
小孩儿	小孩兒	xiao3 hai2 r5	erhua variant of 小孩[xiao3 hai2];  
小姐	小姐	xiǎo jie	young lady; miss; (slang) prostitute; CL:個|个[ge4],位[wei4];  
小朋友	小朋友	xiǎo péng yoǔ	child; CL:個|个[ge4];  
小时	小時	xiǎo shí	hour; CL:個|个[ge4];  
小学	小學	xiǎo xué	elementary school; primary school; CL:個|个[ge4];  
小学生	小學生	xiǎo xué shēng	primary school student; schoolchild; CL:個|个[ge4],名[ming2];  
笑	笑	xiào, xiào	laugh; smile; CL:個|个[ge4];  
写	寫	xiě	to write;  
谢谢	謝謝	xiè xie	to thank; thanks; thank you;  
新	新	Xīn, xīn	abbr. for Xinjiang 新疆[Xin1 jiang1] or Singapore 新加坡[Xin1 jia1 po1]; surname Xin;  new; newly; meso- (chemistry);  
新年	新年	xīn nián	New Year; CL:個|个[ge4];  
星期	星期	xīng qī	week; CL:個|个[ge4]; day of the week; Sunday;  
星期日	星期日	Xīng qī rì	Sunday; CL:個|个[ge4];  
星期天	星期天	Xīng qī tiān	Sunday; CL:個|个[ge4];  
行	行	háng, xíng	a row; series; age order (of brothers); profession; professional; relating to company;  to walk; to go; to travel; a visit; temporary; makeshift; current; in circulation; to do; to perform; capable; competent; effective; all right; OK!; will do; behavior; conduct; Taiwan pr. [xing4] for the behavior-conduct sense;  
休息	休息	xiū xi	rest; to rest;  
学	學	xué	to learn; to study; to imitate; science; -ology;  
学生	學生	xué sheng	student; schoolchild;  
学习	學習	xué xí	to learn; to study;  
学校	學校	xué xiào	school; CL:所[suo3];  
学院	學院	xué yuàn	college; educational institute; school; faculty; CL:所[suo3];  
要	要	yāo, yào	to demand; to request; to coerce;  important; vital; to want; to ask for; will; going to (as future auxiliary); may; must; (used in a comparison) must be; probably; if;  
爷爷	爺爺	yé ye	(coll.) father's father; paternal grandfather; CL:個|个[ge4];  
也	也	Yě, yě	surname Ye;  also; too; (in Classical Chinese) final particle implying affirmation;  
页	頁	yè	page; leaf;  
一	一	yī	one; 1; single; a (article); as soon as; entire; whole; all; throughout; 'one' radical in Chinese characters (Kangxi radical 1); also pr. [yao1] for greater clarity when spelling out numbers digit by digit;  
衣服	衣服	yī fu	clothes; CL:件[jian4],套[tao4];  
医生	醫生	yī shēng	doctor; CL:個|个[ge4],位[wei4],名[ming2];  
医院	醫院	yī yuàn	hospital; CL:所[suo3],家[jia1],座[zuo4];  
一半	一半	yī bàn	half;  
一会儿	一會兒	yi1 hui4 r5	a moment; a while; in a moment; now...now...; also pr. [yi1 hui3 r5];  
一块儿	一塊兒	yi1 kuai4 r5	erhua variant of 一塊|一块[yi1 kuai4];  
一下儿	一下兒	yi1 xia4 r5	erhua variant of 一下[yi1 xia4];  
一样	一樣	yī yàng	same; like; equal to; the same as; just like;  
一边	一邊	yī biān	one side; either side; on the one hand; on the other hand; doing while;  
一点儿	一點兒	yi1 dian3 r5	erhua variant of 一點|一点[yi1 dian3];  
一起	一起	yī qǐ	in the same place; together; with; altogether (in total);  
一些	一些	yī xiē	some; a few; a little;  
用	用	yòng	to use; to employ; to have to; to eat or drink; expense or outlay; usefulness; hence; therefore;  
有	有	yoǔ	to have; there is; there are; to exist; to be;  
有的	有的	yoǔ de	(there are) some (who are...); some (exist);  
有名	有名	yoǔ míng	famous; well-known;  
有时候	有時候	yoǔ shí hou	sometimes;  
有些	有些	yoǔ xiē	some; somewhat;  
有用	有用	yoǔ yòng	useful;  
右	右	yoù	right (-hand); the Right (politics); west (old);  
右边	右邊	yoù bian	right side; right, to the right;  
雨	雨	yǔ, yù	rain; CL:陣|阵[zhen4],場|场[chang2];  to rain; (of rain, snow etc) to fall; to precipitate; to wet;  
元	元	Yuán, yuán	surname Yuan; the Yuan or Mongol dynasty (1279-1368);  currency unit (esp. Chinese yuan); first; original; primary; fundamental; constituent; part; era (of a reign); (math.) argument; variable; (Tw) (geology) eon;  
远	遠	yuǎn, yuàn	far; distant; remote; (intensifier in a comparison) by far; much (lower etc);  to distance oneself from (classical);  
月	月	yuè	moon; month; monthly; CL:個|个[ge4],輪|轮[lun2];  
再	再	zài	again; once more; re-; second; another; then (after sth, and not until then);  
再见	再見	zài jiàn	goodbye; see you again later;  
在	在	zài	(located) at; (to be) in; to exist; in the middle of doing sth; (indicating an action in progress);  
在家	在傢	zàijiā	At home
早	早	zǎo	early; morning; Good morning!; long ago; prematurely;  
早饭	早飯	zǎo fàn	breakfast; CL:份[fen4],頓|顿[dun4],次[ci4],餐[can1];  
早上	早上	zǎo shang	early morning; CL:個|个[ge4];  
怎么	怎麼	zěn me, zěn me	variant of 怎麼|怎么[zen3 me5];  
站	站	zhàn	station; to stand; to halt; to stop; branch of a company or organization; website;  
找	找	zhǎo	to try to find; to look for; to call on sb; to find; to seek; to return; to give change;  
找到	找到	zhǎo dào	to find;  
这	這	zhè	this; these; (commonly pr. [zhei4] before a classifier, esp. in Beijing);  
这边	這邊	zhè biān	this side; here;  
这里	這裏	zhè lǐ, zhè lǐ	here;  
这儿	這兒	zhe4 r5	here;  
这些	這些	zhè xiē	these;  
着	著	zhāo, zháo, zhe, zhuó	(chess) move; trick; all right!; (dialect) to add;  to touch; to come in contact with; to feel; to be affected by; to catch fire; to burn; (coll.) to fall asleep; (after a verb) hitting the mark; succeeding in;  aspect particle indicating action in progress;  to wear (clothes); to contact; to use; to apply;  
真	真	zhēn	really; truly; indeed; real; true; genuine;  
真的	真的	zhēnde	Really
正	正	zhēng, zhèng	first month of the lunar year;  straight; upright; proper; main; principal; to correct; to rectify; exactly; just (at that time); right (in that place); (math.) positive;  
正在	正在	zhèng zài	just at (that time); right in (that place); right in the middle of (doing sth);  
知道	知道	zhī dào	to know; to become aware of; also pr. [zhi1 dao5];  
知识	知識	zhī shi	knowledge; CL:門|门[men2]; intellectual;  
中	中	Zhōng, zhōng, zhòng	China; Chinese; surname Zhong;  within; among; in; middle; center; while (doing sth); during; (dialect) OK; all right;  to hit (the mark); to be hit by; to suffer; to win (a prize, a lottery);  
中国	中國	Zhōng guó	China;  
中间	中間	zhōng jiān	between; intermediate; mid; middle;  
中文	中文	Zhōng wén	Chinese language;  
中午	中午	zhōng wǔ	noon; midday; CL:個|个[ge4];  
中学	中學	zhōng xué	middle school; CL:個|个[ge4];  
中学生	中學生	zhōng xué shēng	middle-school student; high school student;  
重	重	chóng, zhòng	to repeat; repetition; again; re-; classifier: layer;  heavy; serious; to attach importance to;  
重要	重要	zhòng yào	important; significant; major;  
住	住	zhù	to live; to dwell; to stay; to reside; to stop; (suffix indicating firmness, steadiness, or coming to a halt);  
准备	準備	zhǔn bèi	preparation; to prepare; to intend; to be about to; reserve (fund);  
桌子	桌子	zhuō zi	table; desk; CL:張|张[zhang1],套[tao4];  
字	字	zì	letter; symbol; character; word; CL:個|个[ge4]; courtesy or style name traditionally given to males aged 20 in dynastic China;  
子	子	zǐ, zi	son; child; seed; egg; small thing; 1st earthly branch: 11 p.m.-1 a.m., midnight, 11th solar month (7th December to 5th January), year of the Rat; Viscount, fourth of five orders of nobility 五等爵位[wu3 deng3 jue2 wei4]; ancient Chinese compass point: 0° (north);  (noun suffix);  
走	走	zoǔ	to walk; to go; to run; to move (of vehicle); to visit; to leave; to go away; to die (euph.); from; through; away (in compound verbs, such as 撤走[che4 zou3]); to change (shape, form, meaning);  
走路	走路	zoǔ lù	to walk; to go on foot;  
最	最	zuì, zuì, zuì	most; the most; -est (superlative suffix);  
最好	最好	zuì hǎo	best; (you) had better (do what we suggest);  
最后	最後	zuì hoù	final; last; finally; ultimate;  
昨天	昨天	zuó tiān	yesterday;  
左	左	Zuǒ, zuǒ	surname Zuo;  left; the Left (politics); east; unorthodox; queer; wrong; differing; opposite; variant of 佐[zuo3];  
左边	左邊	zuǒ bian	left; the left side; to the left of;  
坐	坐	Zuò, zuò	surname Zuo;  to sit; to take a seat; to take (a bus, airplane etc); to bear fruit; variant of 座[zuo4];  
坐下	坐下	zuò xia	to sit down;  
做	做	zuò	to do; to make; to produce; to write; to compose; to act as; to engage in; to hold (a party); to be; to become; to function (in some capacity); to serve as; to be used for; to form (a bond or relationship); to pretend; to feign; to act a part; to put on appearance;  
